,Player,Span,Mat,Inns,Dis,Ct,St,Ct Wk,Ct Fi,MD,D/I
0,KC Sangakkara (Asia/ICC/SL),2000-2015,404,397,501,402,99,383,19,5 (4ct 1st),1.261
1,AC Gilchrist (AUS/ICC),1996-2008,287,286,472,417,55,417,0,6 (6ct 0st),1.650
2,MS Dhoni (Asia/INDIA),2004-2019,350,345,444,321,123,321,0,6 (5ct 1st),1.286
3,MV Boucher (Afr/SA),1998-2011,295,291,425,403,22,402,1,6 (6ct 0st),1.460
4,Moin Khan (PAK),1990-2004,219,217,287,214,73,214,0,5 (5ct 0st),1.322
5,BB McCullum (NZ),2002-2016,260,257,277,262,15,227,35,5 (5ct 0st),1.077
6,IA Healy (AUS),1988-1997,168,168,233,194,39,194,0,4 (4ct 0st),1.386
7,Mushfiqur Rahim (BDESH),2006-2019,216,215,225,181,44,179,2,5 (5ct 0st),1.046
8,Rashid Latif (PAK),1992-2003,166,164,220,182,38,182,0,5 (5ct 0st),1.341
9,DPMD Jayawardene (Asia/SL),1998-2015,448,443,218,218,0,0,218,4 (4ct 0st),0.492
10,R Dravid (Asia/ICC/INDIA),1996-2011,344,341,210,196,14,72,124,4 (4ct 0st),0.615
11,RS Kaluwitharana (SL),1990-2004,189,188,207,132,75,131,1,5 (4ct 1st),1.101
12,PJL Dujon (WI),1981-1991,169,168,204,183,21,183,0,4 (4ct 0st),1.214
13,JC Buttler (ENG),2012-2019,142,138,202,171,31,171,0,6 (6ct 0st),1.463
14,RD Jacobs (WI),1996-2004,147,145,189,160,29,160,0,6 (5ct 1st),1.303
15,Kamran Akmal (PAK),2002-2017,157,154,188,157,31,156,1,5 (4ct 1st),1.220
16,D Ramdin (WI),2005-2016,139,137,188,181,7,181,0,5 (5ct 0st),1.372
17,AB de Villiers (Afr/SA),2005-2018,228,223,181,176,5,93,83,5 (5ct 0st),0.811
18,BJ Haddin (AUS),2001-2015,126,124,181,170,11,170,0,5 (5ct 0st),1.459
19,AJ Stewart (ENG),1989-2003,170,169,174,159,15,148,11,6 (6ct 0st),1.029
20,A Flower (ZIM),1992-2003,213,212,173,141,32,133,8,5 (5ct 0st),0.816
21,Q de Kock (SA),2013-2019,115,111,166,158,8,158,0,6 (5ct 1st),1.495
22,DJ Richardson (SA),1991-1998,122,121,165,148,17,148,0,5 (5ct 0st),1.363
23,RT Ponting (AUS/ICC),1995-2012,375,372,160,160,0,0,160,3 (3ct 0st),0.430
24,M Azharuddin (INDIA),1985-2000,334,332,156,156,0,0,156,4 (4ct 0st),0.469
25,NR Mongia (INDIA),1994-2000,140,139,154,110,44,110,0,5 (4ct 1st),1.107
26,BRM Taylor (ZIM),2004-2019,193,193,154,125,29,96,29,5 (5ct 0st),0.797
27,T Taibu (Afr/ZIM),2001-2012,150,150,147,114,33,112,2,4 (4ct 0st),0.980
28,AC Parore (NZ),1992-2002,179,178,141,116,25,111,5,5 (3ct 2st),0.792
29,Sarfaraz Ahmed (PAK),2007-2019,116,114,140,116,24,116,0,6 (6ct 0st),1.228
30,SR Tendulkar (INDIA),1989-2012,463,456,140,140,0,0,140,4 (4ct 0st),0.307
31,LRPL Taylor (NZ),2006-2019,228,224,137,137,0,0,137,4 (4ct 0st),0.611
32,Younis Khan (PAK),2000-2015,265,260,135,135,0,5,130,4 (4ct 0st),0.519
33,SP Fleming (ICC/NZ),1994-2007,280,276,133,133,0,0,133,4 (4ct 0st),0.481
34,JH Kallis (Afr/ICC/SA),1996-2014,328,324,131,131,0,0,131,3 (3ct 0st),0.404
35,M Muralitharan (Asia/ICC/SL),1993-2011,350,347,130,130,0,0,130,3 (3ct 0st),0.374
36,AR Border (AUS),1979-1994,273,270,127,127,0,0,127,3 (3ct 0st),0.470
37,Shahid Afridi (Asia/ICC/PAK),1996-2015,398,392,127,127,0,0,127,2 (2ct 0st),0.323
38,Khaled Mashud (BDESH),1995-2006,126,126,126,91,35,91,0,5 (3ct 2st),1.000
39,TM Dilshan (SL),1999-2016,330,325,124,123,1,5,118,3 (3ct 0st),0.381
40,CH Gayle (ICC/WI),1999-2019,301,294,124,124,0,0,124,3 (3ct 0st),0.421
41,RW Marsh (AUS),1971-1984,92,92,124,120,4,120,0,5 (5ct 0st),1.347
42,ST Jayasuriya (Asia/SL),1989-2011,445,441,123,123,0,0,123,3 (3ct 0st),0.278
43,V Kohli (INDIA),2008-2019,239,237,122,122,0,0,122,3 (3ct 0st),0.514
44,CL Hooper (WI),1987-2003,227,225,120,120,0,0,120,4 (4ct 0st),0.533
45,BC Lara (ICC/WI),1990-2007,299,296,120,120,0,0,120,3 (3ct 0st),0.405
46,L Ronchi (AUS/NZ),2008-2017,85,83,117,105,12,105,0,4 (4ct 0st),1.409
47,MS Wade (AUS),2012-2017,94,94,117,108,9,108,0,5 (5ct 0st),1.244
48,Inzamam-ul-Haq (Asia/PAK),1991-2007,378,373,113,113,0,0,113,3 (3ct 0st),0.302
49,SR Waugh (AUS),1986-2002,325,324,111,111,0,0,111,3 (3ct 0st),0.342
50,RS Mahanama (SL),1986-1999,213,212,109,109,0,0,109,3 (3ct 0st),0.514
51,PD Collingwood (ENG),2001-2011,197,197,108,108,0,0,108,3 (3ct 0st),0.548
52,HH Gibbs (SA),1996-2010,248,246,108,108,0,0,108,3 (3ct 0st),0.439
53,SM Pollock (Afr/ICC/SA),1996-2008,303,300,108,108,0,0,108,2 (2ct 0st),0.360
54,ME Waugh (AUS),1988-2002,244,243,108,108,0,0,108,3 (3ct 0st),0.444
55,MJ Clarke (AUS),2003-2015,245,243,106,106,0,0,106,4 (4ct 0st),0.436
56,MEK Hussey (AUS),2004-2012,185,184,105,105,0,0,105,3 (3ct 0st),0.570
57,JN Rhodes (SA),1992-2003,245,242,105,105,0,0,105,5 (5ct 0st),0.433
58,GC Smith (Afr/SA),2002-2013,197,196,105,105,0,0,105,4 (4ct 0st),0.535
59,NJ O'Brien (IRE),2006-2018,103,99,104,90,14,82,8,5 (5ct 0st),1.050
60,Saleem Yousuf (PAK),1982-1990,86,86,103,81,22,81,0,4 (3ct 1st),1.197
61,SK Raina (INDIA),2005-2018,226,223,102,102,0,0,102,3 (3ct 0st),0.457
62,SC Ganguly (Asia/INDIA),1992-2007,311,309,100,100,0,0,100,3 (3ct 0st),0.323
63,IVA Richards (WI),1975-1991,187,186,100,100,0,0,100,3 (3ct 0st),0.537
64,Shoaib Malik (PAK),1999-2019,287,285,98,98,0,0,98,2 (2ct 0st),0.343
65,CZ Harris (NZ),1990-2004,250,247,96,96,0,0,96,4 (4ct 0st),0.388
66,PA de Silva (SL),1984-2003,308,307,95,95,0,0,95,3 (3ct 0st),0.309
67,HP Tillakaratne (SL),1986-2003,200,199,95,89,6,39,50,5 (5ct 0st),0.477
68,Yuvraj Singh (Asia/INDIA),2000-2017,304,298,94,94,0,0,94,3 (3ct 0st),0.315
69,V Sehwag (Asia/ICC/INDIA),1999-2013,251,246,93,93,0,0,93,3 (3ct 0st),0.378
70,MJ Guptill (NZ),2009-2019,179,177,90,90,0,0,90,4 (4ct 0st),0.508
71,Ijaz Ahmed (PAK),1986-2000,250,249,90,90,0,0,90,3 (3ct 0st),0.361
72,KS More (INDIA),1984-1993,94,93,90,63,27,63,0,5 (3ct 2st),0.967
73,Umar Akmal (PAK),2009-2019,121,119,90,77,13,45,32,5 (5ct 0st),0.756
74,Mohammad Shahzad (AFG),2009-2019,84,83,89,64,25,63,1,5 (4ct 1st),1.072
75,DL Vettori (ICC/NZ),1997-2015,295,289,88,88,0,0,88,2 (2ct 0st),0.304
76,Wasim Akram (PAK),1984-2003,356,352,88,88,0,0,88,3 (3ct 0st),0.250
77,HM Amla (SA),2008-2019,181,176,87,87,0,0,87,4 (4ct 0st),0.494
78,GW Flower (ZIM),1992-2010,221,220,86,86,0,0,86,2 (2ct 0st),0.390
79,TWM Latham (NZ),2012-2019,95,93,86,79,7,53,26,5 (5ct 0st),0.924
80,IDS Smith (NZ),1980-1992,98,97,86,81,5,80,1,3 (3ct 0st),0.886
81,A Kumble (Asia/INDIA),1990-2007,271,268,85,85,0,0,85,2 (2ct 0st),0.317
82,Mohammad Hafeez (PAK),2003-2019,218,216,85,85,0,0,85,2 (2ct 0st),0.393
83,NJ Astle (NZ),1995-2007,223,219,83,83,0,0,83,3 (3ct 0st),0.378
84,EJG Morgan (ENG/IRE),2006-2019,233,227,83,83,0,3,80,3 (3ct 0st),0.365
85,GC Wilson (IRE),2007-2019,105,101,83,73,10,49,24,4 (4ct 0st),0.821
86,JP Duminy (SA),2004-2019,199,195,82,82,0,0,82,3 (3ct 0st),0.420
87,A Symonds (AUS),1998-2009,198,196,82,82,0,0,82,4 (4ct 0st),0.418
88,F du Plessis (SA),2011-2019,143,141,81,81,0,0,81,3 (3ct 0st),0.574
89,Saleem Malik (PAK),1982-1999,283,277,81,81,0,1,80,4 (4ct 0st),0.292
90,SK Warne (AUS/ICC),1993-2005,194,193,80,80,0,0,80,3 (3ct 0st),0.414
91,UDU Chandana (SL),1994-2007,147,146,79,79,0,0,79,3 (3ct 0st),0.541
92,MJ Prior (ENG),2004-2011,68,68,79,71,8,69,2,6 (6ct 0st),1.161
93,RG Sharma (INDIA),2007-2019,218,217,77,77,0,0,77,3 (3ct 0st),0.354
94,ADR Campbell (ZIM),1992-2003,188,187,76,76,0,2,74,3 (3ct 0st),0.406
95,RB Richardson (WI),1983-1996,224,222,75,75,0,0,75,4 (4ct 0st),0.337
96,JE Root (ENG),2013-2019,143,139,74,74,0,0,74,3 (3ct 0st),0.532
97,JC Adams (WI),1992-2001,127,127,73,68,5,26,42,5 (4ct 1st),0.574
98,DJ Bravo (WI),2004-2014,164,161,73,73,0,0,73,3 (3ct 0st),0.453
99,S Chanderpaul (WI),1994-2011,268,264,73,73,0,0,73,2 (2ct 0st),0.276
100,WJ Cronje (SA),1992-2000,188,186,73,73,0,0,73,2 (2ct 0st),0.392
101,SD Hope (WI),2016-2019,66,63,73,64,9,64,0,4 (4ct 0st),1.158
102,Javed Miandad (PAK),1975-1996,233,229,73,71,2,1,70,3 (3ct 0st),0.318
103,SB Styris (NZ),1999-2011,188,185,73,73,0,0,73,3 (3ct 0st),0.394
104,E Chigumbura (Afr/ZIM),2004-2018,213,212,72,72,0,0,72,4 (4ct 0st),0.339
105,MH Cross (SCOT),2014-2019,49,48,72,68,4,68,0,6 (6ct 0st),1.500
106,GO Jones (ENG/PNG),2004-2014,51,51,72,68,4,68,0,5 (5ct 0st),1.411
107,Harbhajan Singh (Asia/INDIA),1998-2015,236,231,71,71,0,0,71,3 (3ct 0st),0.307
108,N Kapil Dev (INDIA),1978-1994,225,222,71,71,0,0,71,3 (3ct 0st),0.319
109,KD Karthik (INDIA),2004-2019,94,94,71,64,7,35,29,4 (4ct 0st),0.755
110,H Masakadza (ZIM),2001-2019,209,209,71,71,0,0,71,2 (2ct 0st),0.339
111,MS Atapattu (SL),1990-2007,268,266,70,70,0,0,70,3 (3ct 0st),0.263
112,MG Bevan (AUS),1994-2004,232,230,69,69,0,0,69,3 (3ct 0st),0.300
113,DR Martyn (AUS),1992-2006,208,205,69,69,0,0,69,3 (3ct 0st),0.336
114,A Bagai (CAN),2003-2013,62,62,68,59,9,58,1,4 (4ct 0st),1.096
115,CO Browne (WI),1995-2005,46,46,68,59,9,59,0,5 (5ct 0st),1.478
116,ML Hayden (AUS/ICC),1993-2008,161,158,68,68,0,0,68,2 (2ct 0st),0.430
117,DJG Sammy (WI),2004-2015,126,124,67,67,0,0,67,3 (3ct 0st),0.540
118,SO Tikolo (Afr/KENYA),1996-2014,135,135,67,67,0,0,67,3 (3ct 0st),0.496
119,CL Cairns (ICC/NZ),1991-2006,215,214,66,66,0,0,66,3 (3ct 0st),0.308
120,LD Chandimal (SL),2010-2019,146,143,66,59,7,31,28,4 (3ct 1st),0.461
121,MD Crowe (NZ),1982-1995,143,141,66,66,0,0,66,3 (3ct 0st),0.468
122,Misbah-ul-Haq (PAK),2002-2015,162,160,66,66,0,0,66,4 (4ct 0st),0.412
123,C Kieswetter (ENG),2010-2013,46,45,65,53,12,52,1,5 (2ct 3st),1.444
124,GJ Maxwell (AUS),2012-2019,110,110,65,65,0,0,65,4 (4ct 0st),0.590
125,SPD Smith (AUS),2010-2019,118,118,65,65,0,0,65,3 (3ct 0st),0.550
126,GA Hick (ENG),1991-2001,120,119,64,64,0,0,64,3 (3ct 0st),0.537
127,SR Watson (AUS),2002-2015,190,189,64,64,0,0,64,2 (2ct 0st),0.338
128,KJ O'Brien (IRE),2006-2019,142,138,63,63,0,0,63,3 (3ct 0st),0.456
129,WTS Porterfield (IRE),2006-2019,136,131,63,63,0,0,63,3 (3ct 0st),0.480
130,A Ranatunga (SL),1982-1999,269,268,63,63,0,0,63,3 (3ct 0st),0.235
131,DJ Cullinan (SA),1993-2000,138,135,62,62,0,0,62,3 (3ct 0st),0.459
132,S Dhawan (INDIA),2010-2019,133,131,62,62,0,0,62,4 (4ct 0st),0.473
133,G Kirsten (SA),1993-2003,185,183,62,61,1,1,60,3 (3ct 0st),0.338
134,Wasim Bari (PAK),1973-1984,51,50,62,52,10,52,0,4 (3ct 1st),1.240
135,AL Logie (WI),1981-1993,158,158,61,61,0,0,61,3 (3ct 0st),0.386
136,Mahmudullah (BDESH),2007-2019,185,184,61,61,0,0,61,3 (3ct 0st),0.331
137,Mashrafe Mortaza (Asia/BDESH),2001-2019,217,217,61,61,0,0,61,2 (2ct 0st),0.281
138,NLTC Perera (SL),2009-2019,161,157,61,61,0,0,61,2 (2ct 0st),0.388
139,WPUJC Vaas (Asia/SL),1994-2008,322,320,60,60,0,0,60,2 (2ct 0st),0.187
140,KS Williamson (NZ),2010-2019,149,148,60,60,0,0,60,3 (3ct 0st),0.405
141,AJ Finch (AUS),2013-2019,119,119,59,59,0,0,59,3 (3ct 0st),0.495
142,DL Haynes (WI),1978-1994,238,236,59,59,0,0,59,2 (2ct 0st),0.250
143,A Jadeja (INDIA),1992-2000,196,195,59,59,0,0,59,2 (2ct 0st),0.302
144,DA Miller (SA),2010-2019,126,123,59,59,0,0,59,3 (3ct 0st),0.479
145,Mohammad Yousuf (Asia/PAK),1998-2010,288,285,58,58,0,0,58,2 (2ct 0st),0.203
146,MA Ouma (KENYA),2004-2014,80,80,58,48,10,43,5,5 (3ct 2st),0.725
147,RA Jadeja (INDIA),2009-2019,156,155,57,57,0,0,57,2 (2ct 0st),0.367
148,KO Otieno (KENYA),1996-2009,90,90,57,43,14,40,3,4 (3ct 1st),0.633
149,AJ Strauss (ENG),2003-2011,127,127,57,57,0,0,57,3 (3ct 0st),0.448
150,MA Taylor (AUS),1989-1997,113,113,56,56,0,0,56,4 (4ct 0st),0.495
151,RA Harper (WI),1983-1996,105,105,55,55,0,0,55,3 (3ct 0st),0.523
152,M Kaif (INDIA),2002-2006,125,122,55,55,0,0,55,4 (4ct 0st),0.450
153,Mohammad Nabi (AFG),2009-2019,121,118,55,55,0,0,55,3 (3ct 0st),0.466
154,TD Paine (AUS),2009-2018,35,34,55,51,4,51,0,5 (5ct 0st),1.617
155,PV Simmons (WI),1987-1999,143,143,55,55,0,0,55,4 (4ct 0st),0.384
156,IR Bell (ENG),2004-2015,161,160,54,54,0,0,54,3 (3ct 0st),0.337
157,DM Jones (AUS),1984-1994,164,164,54,54,0,0,54,2 (2ct 0st),0.329
158,B Lee (AUS),2000-2012,221,217,54,54,0,0,54,3 (3ct 0st),0.248
159,Tamim Iqbal (BDESH),2007-2019,204,203,54,54,0,0,54,2 (2ct 0st),0.266
160,JM Anderson (ENG),2002-2015,194,192,53,53,0,0,53,3 (3ct 0st),0.276
161,JR Murray (WI),1992-1999,55,55,53,46,7,44,2,3 (3ct 0st),0.963
162,KA Pollard (WI),2007-2016,101,99,53,53,0,0,53,4 (4ct 0st),0.535
163,DA Warner (AUS),2009-2019,116,116,53,53,0,0,53,2 (2ct 0st),0.456
164,AB Agarkar (INDIA),1998-2007,191,188,52,52,0,0,52,2 (2ct 0st),0.276
165,AD Mathews (SL),2008-2019,214,210,52,52,0,0,52,3 (3ct 0st),0.247
166,CS Baugh (WI),2003-2012,47,46,51,39,12,39,0,4 (2ct 2st),1.108
167,JDP Oram (NZ),2001-2012,160,159,51,51,0,0,51,2 (2ct 0st),0.320
168,JG Wright (NZ),1978-1992,149,147,51,51,0,0,51,2 (2ct 0st),0.346
169,MN Samuels (WI),2000-2018,207,207,50,50,0,0,50,2 (2ct 0st),0.241
170,Shakib Al Hasan (BDESH),2006-2019,206,205,50,50,0,0,50,3 (3ct 0st),0.243
171,WU Tharanga (Asia/SL),2005-2019,235,228,50,50,0,0,50,3 (3ct 0st),0.219
172,P Utseya (ZIM),2004-2015,164,164,50,50,0,0,50,2 (2ct 0st),0.304
173,Aamer Sohail (PAK),1990-2000,156,154,49,49,0,0,49,2 (2ct 0st),0.318
174,AP Gurusinha (SL),1985-1996,147,147,49,49,0,2,47,2 (2ct 0st),0.333
175,WB Phillips (AUS),1982-1986,48,48,49,42,7,42,0,4 (3ct 1st),1.020
176,ME Trescothick (ENG),2000-2006,123,121,49,49,0,4,45,3 (3ct 0st),0.404
177,KC Wessels (AUS/SA),1983-1994,109,106,49,49,0,0,49,4 (4ct 0st),0.462
178,SC Williams (ZIM),2005-2019,131,130,49,49,0,0,49,3 (3ct 0st),0.376
179,RP Arnold (SL),1997-2007,180,179,48,48,0,0,48,2 (2ct 0st),0.268
180,GJ Bailey (AUS),2012-2016,90,90,48,48,0,0,48,3 (3ct 0st),0.533
181,AM Rahane (INDIA),2011-2018,90,87,48,48,0,0,48,2 (2ct 0st),0.551
182,J Smits (NL),2003-2009,38,38,48,41,7,41,0,4 (4ct 0st),1.263
183,N Dickwella (SL),2014-2019,52,52,47,38,9,38,0,4 (2ct 2st),0.903
184,A Flintoff (ENG/ICC),1999-2009,141,140,47,47,0,0,47,3 (3ct 0st),0.335
185,RC Russell (ENG),1987-1998,40,40,47,41,6,41,0,3 (3ct 0st),1.175
186,JO Holder (WI),2013-2019,107,104,46,46,0,0,46,2 (2ct 0st),0.442
187,KMDN Kulasekara (SL),2003-2017,184,181,46,46,0,0,46,3 (3ct 0st),0.254
188,MDKJ Perera (SL),2013-2019,98,97,46,43,3,26,17,4 (4ct 0st),0.474
189,HH Streak (Afr/ZIM),1993-2005,189,188,46,46,0,0,46,2 (2ct 0st),0.244
190,CEL Ambrose (WI),1988-2000,176,175,45,45,0,0,45,3 (3ct 0st),0.257
191,DC Boon (AUS),1984-1995,181,181,45,45,0,0,45,2 (2ct 0st),0.248
192,GA Gooch (ENG),1976-1995,125,125,45,45,0,0,45,2 (2ct 0st),0.360
193,CG Greenidge (WI),1975-1991,128,127,45,45,0,0,45,2 (2ct 0st),0.354
194,RR Sarwan (WI),2000-2013,181,176,45,45,0,0,45,2 (2ct 0st),0.255
195,BA Stokes (ENG),2011-2019,95,92,45,45,0,0,45,3 (3ct 0st),0.489
196,D Williams (WI),1988-1997,36,35,45,35,10,35,0,4 (4ct 0st),1.285
197,DI Gower (ENG),1978-1991,114,114,44,44,0,0,44,3 (3ct 0st),0.385
198,NV Knight (ENG),1996-2003,100,100,44,44,0,0,44,2 (2ct 0st),0.440
199,CD McMillan (NZ),1997-2007,197,193,44,44,0,0,44,2 (2ct 0st),0.227
200,DO Obuya (KENYA),2001-2012,74,74,44,39,5,23,16,4 (1ct 3st),0.594
201,CR Woakes (ENG),2011-2019,99,95,44,44,0,0,44,4 (4ct 0st),0.463
202,Z Khan (Asia/INDIA),2000-2012,200,197,43,43,0,0,43,3 (3ct 0st),0.218
203,CO Obuya (KENYA),2001-2014,104,104,43,43,0,0,43,3 (3ct 0st),0.413
204,RL Powell (WI),1999-2005,109,107,43,43,0,0,43,3 (3ct 0st),0.401
205,CMW Read (ENG),2000-2006,36,35,43,41,2,41,0,5 (5ct 0st),1.228
206,CR Ervine (ZIM),2010-2019,93,92,42,42,0,0,42,4 (4ct 0st),0.456
207,BM McMillan (SA),1991-1998,78,77,42,42,0,0,42,3 (3ct 0st),0.545
208,KD Mills (NZ),2001-2015,170,169,42,42,0,0,42,3 (3ct 0st),0.248
209,Saeed Anwar (PAK),1989-2003,247,242,42,42,0,0,42,3 (3ct 0st),0.173
210,V Sibanda (Afr/ZIM),2003-2016,127,127,42,42,0,0,42,2 (2ct 0st),0.330
211,K Srikkanth (INDIA),1981-1992,146,145,42,42,0,0,42,2 (2ct 0st),0.289
212,PR Stirling (IRE),2008-2019,114,110,42,42,0,0,42,3 (3ct 0st),0.381
213,GP Thorpe (ENG),1993-2002,82,81,42,42,0,0,42,3 (3ct 0st),0.518
214,NL McCullum (NZ),2009-2015,84,83,41,41,0,0,41,4 (4ct 0st),0.493
215,KR Rutherford (NZ),1985-1995,121,121,41,41,0,0,41,4 (4ct 0st),0.338
216,L Vincent (NZ),2001-2007,102,100,41,41,0,2,39,2 (2ct 0st),0.410
217,JV Coney (NZ),1979-1987,88,86,40,40,0,0,40,3 (3ct 0st),0.465
218,N Hussain (ENG),1989-2003,88,88,40,40,0,0,40,2 (2ct 0st),0.454
219,KP Pietersen (ENG/ICC),2004-2013,136,135,40,40,0,0,40,2 (2ct 0st),0.296
220,Saqlain Mushtaq (PAK),1995-2003,169,166,40,40,0,0,40,2 (2ct 0st),0.240
221,RJ Shastri (INDIA),1981-1992,150,148,40,40,0,0,40,2 (2ct 0st),0.270
222,AT Carey (AUS),2018-2019,29,29,39,34,5,34,0,5 (4ct 1st),1.344
223,SV Carlisle (ZIM),1995-2005,111,111,39,39,0,0,39,3 (3ct 0st),0.351
224,VVS Laxman (INDIA),1998-2006,86,85,39,39,0,0,39,4 (4ct 0st),0.458
225,CH Lloyd (WI),1973-1985,87,87,39,39,0,0,39,3 (3ct 0st),0.448
226,PA Patel (INDIA),2003-2012,38,36,39,30,9,30,0,4 (3ct 1st),1.083
227,TG Southee (NZ),2008-2019,140,139,39,39,0,0,39,3 (3ct 0st),0.280
228,TE Blain (NZ),1986-1994,38,38,38,37,1,36,1,4 (4ct 0st),1.000
229,DSBP Kuruppu (SL),1983-1990,54,54,38,30,8,26,4,4 (3ct 1st),0.703
230,DL Murray (WI),1973-1980,26,26,38,37,1,37,0,4 (4ct 0st),1.461
231,Sikandar Raza (ZIM),2013-2019,97,96,38,38,0,0,38,3 (3ct 0st),0.395
232,HDRL Thirimanne (SL),2010-2019,127,125,38,38,0,0,38,2 (2ct 0st),0.304
233,Azhar Mahmood (PAK),1996-2007,143,140,37,37,0,0,37,2 (2ct 0st),0.264
234,AG Cremer (ZIM),2009-2018,96,95,37,37,0,0,37,2 (2ct 0st),0.389
235,GD McGrath (AUS/ICC),1993-2007,250,248,37,37,0,0,37,3 (3ct 0st),0.149
236,S Matsikenyeri (ZIM),2002-2015,113,113,37,37,0,0,37,3 (3ct 0st),0.327
237,BKV Prasad (INDIA),1994-2001,161,160,37,37,0,0,37,3 (3ct 0st),0.231
238,Sabbir Rahman (BDESH),2014-2019,66,65,37,37,0,0,37,3 (3ct 0st),0.569
239,RG Twose (NZ),1995-2001,87,87,37,37,0,0,37,2 (2ct 0st),0.425
240,DB Vengsarkar (INDIA),1976-1991,129,127,37,37,0,0,37,3 (3ct 0st),0.291
241,CL White (AUS),2005-2018,91,90,37,37,0,0,37,3 (3ct 0st),0.411
242,Babar Azam (PAK),2015-2019,74,73,36,36,0,0,36,2 (2ct 0st),0.493
243,JM Bairstow (ENG),2011-2019,74,71,36,34,2,12,22,4 (4ct 0st),0.507
244,J Botha (Afr/SA),2005-2012,78,77,36,36,0,0,36,3 (3ct 0st),0.467
245,IT Botham (ENG),1976-1992,116,116,36,36,0,0,36,2 (2ct 0st),0.310
246,AN Cook (ENG),2006-2014,92,91,36,36,0,0,36,2 (2ct 0st),0.395
247,HH Dippenaar (Afr/SA),1999-2007,107,106,36,36,0,2,34,3 (3ct 0st),0.339
248,GH Dockrell (IRE),2010-2019,87,85,36,36,0,0,36,2 (2ct 0st),0.423
249,G Gambhir (INDIA),2003-2013,147,144,36,36,0,0,36,3 (3ct 0st),0.250
250,GB Hogg (AUS),1996-2008,123,121,36,36,0,0,36,2 (2ct 0st),0.297
251,Imran Khan (PAK),1974-1992,175,172,36,36,0,0,36,3 (3ct 0st),0.209
252,SMH Kirmani (INDIA),1976-1986,49,48,36,27,9,27,0,5 (5ct 0st),0.750
253,BKG Mendis (SL),2016-2019,73,72,36,36,0,2,34,2 (2ct 0st),0.500
254,Najibullah Zadran (AFG),2012-2019,64,63,36,36,0,0,36,3 (3ct 0st),0.571
255,GJ Whittall (ZIM),1993-2003,147,146,36,36,0,0,36,4 (4ct 0st),0.246
256,Abdul Razzaq (Asia/PAK),1996-2011,265,262,35,35,0,0,35,2 (2ct 0st),0.133
257,RS Bopara (ENG),2007-2015,120,118,35,35,0,0,35,2 (2ct 0st),0.296
258,MJ Greatbatch (NZ),1988-1996,84,84,35,35,0,1,34,2 (2ct 0st),0.416
259,MG Johnson (AUS),2005-2015,153,152,35,35,0,0,35,2 (2ct 0st),0.230
260,L Klusener (SA),1996-2004,171,169,35,35,0,0,35,2 (2ct 0st),0.207
261,Mohammad Ashraful (Asia/BDESH),2001-2013,177,177,35,35,0,0,35,2 (2ct 0st),0.197
262,Waqar Younis (PAK),1989-2003,262,259,35,35,0,0,35,2 (2ct 0st),0.135
263,HDPK Dharmasena (SL),1994-2004,141,140,34,34,0,0,34,2 (2ct 0st),0.242
264,Nasir Hossain (BDESH),2011-2018,65,65,34,34,0,0,34,2 (2ct 0st),0.523
265,PL Taylor (AUS),1987-1992,83,83,34,34,0,0,34,2 (2ct 0st),0.409
266,N Boje (Afr/SA),1995-2005,115,113,33,33,0,0,33,2 (2ct 0st),0.292
267,DM Bravo (WI),2009-2019,110,107,33,33,0,0,33,3 (3ct 0st),0.308
268,RW Chakabva (ZIM),2008-2019,38,38,33,29,4,17,12,5 (5ct 0st),0.868
269,CJ Chibhabha (ZIM),2005-2018,103,102,33,33,0,0,33,2 (2ct 0st),0.323
270,NH Fairbrother (ENG),1987-1999,75,75,33,33,0,0,33,3 (3ct 0st),0.440
271,RS Kalpage (SL),1992-1999,86,86,33,33,0,0,33,3 (3ct 0st),0.383
272,JM Kemp (Afr/SA),2001-2007,85,84,33,33,0,0,33,3 (3ct 0st),0.392
273,Rameez Raja (PAK),1985-1997,198,193,33,33,0,0,33,2 (2ct 0st),0.170
274,RR Singh (INDIA),1989-2001,136,135,33,33,0,0,33,2 (2ct 0st),0.244
275,CJO Smith (SCOT),2006-2009,27,26,33,22,11,22,0,5 (5ct 0st),1.269
276,Soumya Sarkar (BDESH),2014-2019,55,54,33,33,0,0,33,4 (4ct 0st),0.611
277,Abdur Razzak (BDESH),2004-2014,153,153,32,32,0,0,32,2 (2ct 0st),0.209
278,MM Ali (ENG),2014-2019,101,98,32,32,0,0,32,3 (3ct 0st),0.326
279,Ghulam Shabber (UAE),2017-2019,23,23,32,30,2,30,0,4 (4ct 0st),1.391
280,J Srinath (INDIA),1991-2003,229,227,32,32,0,0,32,2 (2ct 0st),0.140
281,RW Taylor (ENG),1973-1984,27,27,32,26,6,26,0,4 (4ct 0st),1.185
282,DL Houghton (ZIM),1983-1997,63,63,31,29,2,10,19,4 (4ct 0st),0.492
283,CK Kapugedera (SL),2006-2017,102,100,31,31,0,0,31,2 (2ct 0st),0.310
284,AJ Lamb (ENG),1982-1992,122,122,31,31,0,0,31,2 (2ct 0st),0.254
285,SL Malinga (SL),2004-2019,226,220,31,31,0,0,31,2 (2ct 0st),0.140
286,GR Marsh (AUS),1986-1992,117,117,31,31,0,0,31,2 (2ct 0st),0.264
287,M Morkel (Afr/SA),2007-2018,117,114,31,31,0,0,31,3 (3ct 0st),0.271
288,JJ Roy (ENG),2015-2019,84,82,31,31,0,0,31,2 (2ct 0st),0.378
289,DR Smith (WI),2004-2015,105,103,31,31,0,0,31,2 (2ct 0st),0.300
290,R Ashwin (INDIA),2010-2017,111,110,30,30,0,0,30,3 (3ct 0st),0.272
291,TA Boult (NZ),2012-2019,89,89,30,30,0,0,30,2 (2ct 0st),0.337
292,RG de Alwis (SL),1983-1988,31,31,30,27,3,27,0,5 (5ct 0st),0.967
293,J Garner (WI),1977-1987,98,98,30,30,0,0,30,3 (3ct 0st),0.306
294,LK Germon (NZ),1994-1997,37,37,30,21,9,21,0,4 (4ct 0st),0.810
295,MA Holding (WI),1976-1987,102,102,30,30,0,0,30,3 (3ct 0st),0.294
296,KM Jadhav (INDIA),2014-2019,68,67,30,30,0,0,30,3 (3ct 0st),0.447
297,SS Karim (INDIA),1997-2000,34,34,30,27,3,27,0,4 (3ct 1st),0.882
298,WK Lees (NZ),1979-1983,31,31,30,28,2,28,0,4 (4ct 0st),0.967
299,Mohammad Rizwan (PAK),2015-2019,32,32,30,29,1,17,12,4 (4ct 0st),0.937
300,Mushtaq Ahmed (PAK),1989-2003,144,144,30,30,0,0,30,2 (2ct 0st),0.208
301,M Ntini (ICC/SA),1998-2009,173,171,30,30,0,0,30,2 (2ct 0st),0.175
302,CS Pandit (INDIA),1986-1992,36,36,30,15,15,15,0,4 (2ct 2st),0.833
303,AU Rashid (ENG),2009-2019,99,96,30,30,0,0,30,3 (3ct 0st),0.312
304,PA Strang (ZIM),1994-2001,95,94,30,30,0,0,30,2 (2ct 0st),0.319
305,Aftab Ahmed (BDESH),2004-2010,85,85,29,29,0,0,29,3 (3ct 0st),0.341
306,TM Alderman (AUS),1981-1991,65,65,29,29,0,0,29,3 (3ct 0st),0.446
307,Alok Kapali (BDESH),2002-2011,69,69,29,29,0,0,29,2 (2ct 0st),0.420
308,PR Downton (ENG),1977-1988,28,28,29,26,3,26,0,4 (4ct 0st),1.035
309,AJ Hall (SA),1999-2007,88,87,29,29,0,0,29,2 (2ct 0st),0.333
310,WW Hinds (WI),1999-2010,119,119,29,29,0,0,29,2 (2ct 0st),0.243
311,DJ Hussey (AUS),2008-2013,69,69,29,29,0,0,29,2 (2ct 0st),0.420
312,GP Swann (ENG),2000-2013,79,78,29,29,0,0,29,3 (3ct 0st),0.371
313,DC Thomas (WI),2009-2013,21,21,29,23,6,23,0,3 (3ct 0st),1.380
314,Ahmed Shehzad (PAK),2009-2017,81,80,28,28,0,0,28,2 (2ct 0st),0.350
315,PW Borren (NL),2006-2014,58,58,28,28,0,0,28,3 (3ct 0st),0.482
316,JJ Crowe (NZ),1983-1990,75,74,28,28,0,0,28,2 (2ct 0st),0.378
317,AA Donald (SA),1991-2003,164,162,28,28,0,0,28,2 (2ct 0st),0.172
318,GC Dyer (AUS),1986-1988,23,23,28,24,4,24,0,4 (4ct 0st),1.217
319,GJ Hopkins (NZ),2004-2010,25,23,28,27,1,27,0,5 (5ct 0st),1.217
320,Mohammad Rafique (Asia/BDESH),1995-2007,125,125,28,28,0,0,28,2 (2ct 0st),0.224
321,R Mutumbami (ZIM),2014-2019,33,33,28,23,5,21,2,4 (4ct 0st),0.848
322,TM Odoyo (Afr/KENYA),1996-2014,136,136,28,28,0,0,28,2 (2ct 0st),0.205
323,RJ Peterson (SA),2002-2014,79,79,28,28,0,0,28,2 (2ct 0st),0.354
324,LMP Simmons (WI),2006-2015,68,68,28,28,0,2,26,2 (2ct 0st),0.411
325,DW Steyn (Afr/SA),2005-2019,125,124,28,28,0,0,28,2 (2ct 0st),0.225
326,BA Young (NZ),1990-1999,74,73,28,28,0,6,22,3 (3ct 0st),0.383
327,KLT Arthurton (WI),1988-1999,105,104,27,27,0,0,27,2 (2ct 0st),0.259
328,F Behardien (SA),2013-2018,59,58,27,27,0,0,27,2 (2ct 0st),0.465
329,SCJ Broad (ENG),2006-2016,121,121,27,27,0,0,27,2 (2ct 0st),0.223
330,CRD Fernando (Asia/SL),2001-2012,147,146,27,27,0,0,27,3 (3ct 0st),0.184
331,Sir RJ Hadlee (NZ),1973-1990,115,113,27,27,0,0,27,2 (2ct 0st),0.238
332,AD Hales (ENG),2014-2019,70,68,27,27,0,0,27,2 (2ct 0st),0.397
333,KJ Hughes (AUS),1977-1985,97,96,27,27,0,0,27,2 (2ct 0st),0.281
334,EC Joyce (ENG/IRE),2006-2018,78,75,27,27,0,0,27,2 (2ct 0st),0.360
335,B Kumar (INDIA),2012-2019,114,113,27,27,0,0,27,2 (2ct 0st),0.238
336,CJ McDermott (AUS),1985-1996,138,138,27,27,0,0,27,1 (1ct 0st),0.195
337,CS MacLeod (SCOT),2008-2019,63,62,27,27,0,0,27,4 (4ct 0st),0.435
338,M Prabhakar (INDIA),1984-1996,130,128,27,27,0,0,27,3 (3ct 0st),0.210
339,Wahab Riaz (PAK),2008-2019,89,88,27,27,0,0,27,2 (2ct 0st),0.306
340,CA Walsh (WI),1985-2000,205,204,27,27,0,0,27,1 (1ct 0st),0.132
341,RD Berrington (SCOT),2008-2019,75,74,26,26,0,0,26,2 (2ct 0st),0.351
342,NW Bracken (AUS),2001-2009,116,116,26,26,0,0,26,2 (2ct 0st),0.224
343,PAJ DeFreitas (ENG),1987-1997,103,103,26,26,0,0,26,2 (2ct 0st),0.252
344,JEC Franklin (NZ),2001-2013,110,109,26,26,0,0,26,2 (2ct 0st),0.238
345,Habibul Bashar (BDESH),1995-2007,111,111,26,26,0,0,26,2 (2ct 0st),0.234
346,Imran Nazir (PAK),1999-2009,79,78,26,26,0,0,26,3 (3ct 0st),0.333
347,DS Lehmann (AUS),1996-2005,117,116,26,26,0,0,26,3 (3ct 0st),0.224
348,MF Maharoof (SL),2004-2016,109,107,26,26,0,0,26,2 (2ct 0st),0.242
349,LE Plunkett (ENG),2005-2019,89,87,26,26,0,0,26,2 (2ct 0st),0.298
350,AG Prince (Afr/SA),2002-2007,52,51,26,26,0,0,26,4 (4ct 0st),0.509
351,RA Smith (ENG),1988-1996,71,71,26,26,0,0,26,2 (2ct 0st),0.366
352,GP Wickramasinghe (SL),1990-2002,134,134,26,26,0,0,26,2 (2ct 0st),0.194
353,CB Wishart (ZIM),1996-2005,90,90,26,26,0,0,26,2 (2ct 0st),0.288
354,B Zuiderent (NL),1996-2011,57,57,26,26,0,0,26,2 (2ct 0st),0.456
355,W Barresi (NL),2010-2019,32,32,25,17,8,13,4,3 (3ct 0st),0.781
356,D Gough (ENG/ICC),1994-2006,159,157,25,25,0,0,25,1 (1ct 0st),0.159
357,JR Hopes (AUS),2005-2010,84,83,25,25,0,0,25,2 (2ct 0st),0.301
358,Imran Tahir (SA),2011-2019,107,104,25,25,0,0,25,2 (2ct 0st),0.240
359,DT Johnston (IRE),2006-2013,67,65,25,25,0,0,25,2 (2ct 0st),0.384
360,MR Marsh (AUS),2011-2018,53,53,25,25,0,0,25,4 (4ct 0st),0.471
361,Mohammed Shami (INDIA),2013-2019,70,69,25,25,0,0,25,2 (2ct 0st),0.362
362,DJ Nash (NZ),1992-2002,81,80,25,25,0,0,25,3 (3ct 0st),0.312
363,DW Randall (ENG),1976-1985,49,49,25,25,0,0,25,2 (2ct 0st),0.510
364,PR Reiffel (AUS),1992-1999,92,92,25,25,0,0,25,2 (2ct 0st),0.271
365,Saeed Ajmal (PAK),2008-2015,113,112,25,25,0,0,25,1 (1ct 0st),0.223
366,MJ Santner (NZ),2015-2019,69,68,25,25,0,0,25,2 (2ct 0st),0.367
367,MP Vaughan (ENG),2001-2007,86,85,25,25,0,0,25,3 (3ct 0st),0.294
368,Aaqib Javed (PAK),1988-1998,163,159,24,24,0,0,24,1 (1ct 0st),0.150
369,Asghar Afghan (AFG),2009-2019,108,105,24,24,0,0,24,2 (2ct 0st),0.228
370,V Dahiya (INDIA),2000-2001,19,19,24,19,5,19,0,3 (3ct 0st),1.263
371,SS Dighe (INDIA),2000-2001,23,23,24,19,5,19,0,4 (4ct 0st),1.043
372,NM Hauritz (AUS),2002-2011,58,57,24,24,0,0,24,2 (2ct 0st),0.421
373,Liton Das (BDESH),2015-2019,33,33,24,21,3,7,14,4 (4ct 0st),0.727
374,S Viswanath (INDIA),1985-1988,22,22,24,17,7,17,0,5 (3ct 2st),1.090
375,Wasim Raja (PAK),1973-1985,54,52,24,24,0,0,24,2 (2ct 0st),0.461
376,M Amarnath (INDIA),1975-1989,85,84,23,23,0,0,23,2 (2ct 0st),0.273
377,SL Campbell (WI),1994-2001,90,90,23,23,0,0,23,3 (3ct 0st),0.255
378,GS Chappell (AUS),1971-1983,74,72,23,23,0,0,23,2 (2ct 0st),0.319
379,DD Ebrahim (ZIM),2001-2005,82,82,23,23,0,0,23,2 (2ct 0st),0.280
380,AH Jones (NZ),1987-1995,87,87,23,23,0,0,23,2 (2ct 0st),0.264
381,Junaid Siddique (BDESH),2007-2011,54,54,23,23,0,1,22,3 (3ct 0st),0.425
382,GR Larsen (NZ),1990-1999,121,121,23,23,0,0,23,1 (1ct 0st),0.190
383,S Lee (AUS),1995-2001,45,44,23,23,0,0,23,2 (2ct 0st),0.522
384,SV Manjrekar (INDIA),1988-1996,74,74,23,23,0,0,23,2 (2ct 0st),0.310
385,GRJ Matthews (AUS),1984-1993,59,59,23,23,0,0,23,3 (3ct 0st),0.389
386,PJ Moor (ZIM),2014-2019,49,48,23,22,1,16,6,4 (4ct 0st),0.479
387,JDS Neesham (NZ),2013-2019,59,59,23,23,0,0,23,2 (2ct 0st),0.389
388,PA Nixon (ENG),2007-2007,19,19,23,20,3,20,0,2 (2ct 0st),1.210
389,DN Patel (NZ),1987-1997,75,75,23,23,0,0,23,2 (2ct 0st),0.306
390,SW Poynter (IRE),2014-2019,21,21,23,22,1,19,3,4 (4ct 0st),1.095
391,PL Symcox (SA),1993-1999,80,80,23,23,0,0,23,2 (2ct 0st),0.287
392,TJ Zoehrer (AUS),1986-1994,22,22,23,21,2,21,0,4 (4ct 0st),1.045
393,Zulqarnain (PAK),1985-1989,16,14,23,18,5,18,0,4 (4ct 0st),1.642
394,Afsar Zazai (AFG),2014-2017,17,16,22,20,2,20,0,3 (3ct 0st),1.375
395,J Charles (WI),2012-2016,48,48,22,21,1,10,11,2 (2ct 0st),0.458
396,MW Gatting (ENG),1977-1993,92,92,22,22,0,0,22,2 (2ct 0st),0.239
397,SM Gavaskar (INDIA),1974-1987,108,107,22,22,0,0,22,4 (4ct 0st),0.205
398,AF Giles (ENG),1997-2005,62,62,22,22,0,0,22,3 (3ct 0st),0.354
399,SE Marsh (AUS),2008-2019,73,73,22,22,0,0,22,2 (2ct 0st),0.301
400,PL Mommsen (SCOT),2010-2017,44,43,22,22,0,0,22,2 (2ct 0st),0.511
401,C Munro (NZ),2013-2019,57,57,22,22,0,0,22,2 (2ct 0st),0.385
402,SP O'Donnell (AUS),1985-1991,87,87,22,22,0,0,22,2 (2ct 0st),0.252
403,HH Pandya (INDIA),2016-2019,54,53,22,22,0,0,22,2 (2ct 0st),0.415
404,K Rabada (SA),2015-2019,75,73,22,22,0,0,22,2 (2ct 0st),0.301
405,RR Rossouw (SA),2014-2016,36,35,22,22,0,0,22,4 (4ct 0st),0.628
406,MA Starc (AUS),2010-2019,85,85,22,22,0,0,22,2 (2ct 0st),0.258
407,MN Waller (ZIM),2009-2018,79,79,22,22,0,0,22,1 (1ct 0st),0.278
408,RGD Willis (ENG),1973-1984,64,64,22,22,0,0,22,2 (2ct 0st),0.343
409,UT Yadav (INDIA),2010-2018,75,73,22,22,0,0,22,3 (3ct 0st),0.301
410,Abdul Qadir (PAK),1983-1993,104,102,21,21,0,0,21,2 (2ct 0st),0.205
411,DL Bairstow (ENG),1979-1984,21,21,21,17,4,17,0,3 (3ct 0st),1.000
412,Fakhar Zaman (PAK),2017-2019,46,45,21,21,0,0,21,2 (2ct 0st),0.466
413,JP Faulkner (AUS),2013-2017,69,69,21,21,0,0,21,1 (1ct 0st),0.304
414,Imrul Kayes (BDESH),2008-2018,78,78,21,21,0,0,21,2 (2ct 0st),0.269
415,ND McKenzie (SA),2000-2009,64,64,21,21,0,0,21,3 (3ct 0st),0.328
416,Manzoor Elahi (PAK),1984-1995,54,54,21,21,0,0,21,2 (2ct 0st),0.388
417,AF Milne (NZ),2012-2017,40,39,21,21,0,0,21,3 (3ct 0st),0.538
418,D Mongia (INDIA),2001-2007,57,56,21,21,0,0,21,3 (3ct 0st),0.375
419,TM Moody (AUS),1987-1999,76,76,21,21,0,0,21,2 (2ct 0st),0.276
420,Mudassar Nazar (PAK),1977-1989,122,119,21,21,0,0,21,2 (2ct 0st),0.176
421,A Nel (SA),2001-2008,79,77,21,21,0,0,21,2 (2ct 0st),0.272
422,IK Pathan (INDIA),2004-2012,120,118,21,21,0,0,21,1 (1ct 0st),0.177
423,MSK Prasad (INDIA),1998-1999,17,17,21,14,7,14,0,5 (4ct 1st),1.235
424,Rashid Khan (AFG),2015-2019,68,65,21,21,0,0,21,3 (3ct 0st),0.323
425,KAJ Roach (WI),2008-2019,92,90,21,21,0,0,21,2 (2ct 0st),0.233
426,Samiullah Shinwari (AFG),2009-2019,84,84,21,21,0,0,21,2 (2ct 0st),0.250
427,OA Shah (ENG),2001-2009,71,71,21,21,0,0,21,2 (2ct 0st),0.295
428,RV Uthappa (INDIA),2006-2015,46,44,21,19,2,4,15,3 (3ct 0st),0.477
429,AR White (IRE),2006-2014,61,61,21,21,0,0,21,2 (2ct 0st),0.344
430,AR Whittall (ZIM),1996-2000,63,63,21,21,0,0,21,3 (3ct 0st),0.333
431,DJ Willey (ENG),2015-2019,46,45,21,21,0,0,21,2 (2ct 0st),0.466
432,Ashraf Ali (PAK),1980-1985,16,16,20,17,3,17,0,3 (3ct 0st),1.250
433,A Balbirnie (IRE),2010-2019,64,62,20,20,0,0,20,4 (4ct 0st),0.322
434,GB Brent (ZIM),1996-2008,70,70,20,20,0,0,20,2 (2ct 0st),0.285
435,TT Bresnan (ENG),2006-2015,85,84,20,20,0,0,20,2 (2ct 0st),0.238
436,AF Buurman (NL),2007-2011,17,17,20,17,3,15,2,3 (3ct 0st),1.176
437,CK Coventry (ZIM),2003-2015,39,39,20,19,1,0,19,1 (1ct 0st),0.512
438,DN Crookes (SA),1994-2000,32,32,20,20,0,0,20,2 (2ct 0st),0.625
439,M Dillon (WI),1997-2005,108,107,20,20,0,0,20,2 (2ct 0st),0.186
440,JS Foster (ENG),2001-2002,11,11,20,13,7,13,0,3 (2ct 1st),1.818
441,MW Goodwin (ZIM),1998-2000,71,71,20,20,0,0,20,2 (2ct 0st),0.281
442,JK Kamande (KENYA),1999-2011,86,86,20,20,0,0,20,2 (2ct 0st),0.232
443,CC Lewis (ENG),1990-1998,53,53,20,20,0,0,20,2 (2ct 0st),0.377
444,DA Minors (BMUDA),2006-2007,20,20,20,16,4,12,4,3 (3ct 0st),1.000
445,RS Morton (WI),2002-2010,56,55,20,20,0,0,20,3 (3ct 0st),0.363
446,Rubel Hossain (BDESH),2009-2019,101,100,20,20,0,0,20,2 (2ct 0st),0.200
447,Salman Butt (PAK),2004-2010,78,77,20,20,0,0,20,2 (2ct 0st),0.259
448,Shoaib Akhtar (Asia/ICC/PAK),1998-2011,163,162,20,20,0,0,20,2 (2ct 0st),0.123
449,NS Sidhu (INDIA),1987-1998,136,135,20,20,0,0,20,2 (2ct 0st),0.148
450,LPC Silva (SL),1999-2011,75,73,20,20,0,0,20,3 (3ct 0st),0.273
451,SAR Silva (SL),1984-1985,20,20,20,17,3,17,0,3 (3ct 0st),1.000
452,JE Taylor (WI),2003-2017,90,88,20,20,0,0,20,2 (2ct 0st),0.227
453,DR Tuffey (NZ),2000-2010,94,92,20,20,0,0,20,3 (3ct 0st),0.217
454,BJ Watling (NZ),2010-2018,28,28,20,20,0,14,6,3 (3ct 0st),0.714
455,Akram Raza (PAK),1989-1995,49,49,19,19,0,0,19,2 (2ct 0st),0.387
456,AJ Bichel (AUS),1997-2004,67,66,19,19,0,0,19,2 (2ct 0st),0.287
457,JG Bracewell (NZ),1983-1990,53,52,19,19,0,0,19,3 (3ct 0st),0.365
458,BL Cairns (NZ),1974-1985,78,77,19,19,0,0,19,2 (2ct 0st),0.246
459,EJ Chatfield (NZ),1979-1989,114,112,19,19,0,0,19,2 (2ct 0st),0.169
460,DM de Silva (SL),2016-2019,42,42,19,19,0,0,19,2 (2ct 0st),0.452
461,XJ Doherty (AUS),2010-2015,60,60,19,19,0,0,19,2 (2ct 0st),0.316
462,JE Emburey (ENG),1980-1993,61,61,19,19,0,0,19,2 (2ct 0st),0.311
463,JM How (NZ),2005-2011,41,40,19,19,0,0,19,4 (4ct 0st),0.475
464,NC Johnson (ZIM),1998-2000,48,48,19,19,0,0,19,2 (2ct 0st),0.395
465,CJ Jordan (ENG),2013-2016,31,31,19,19,0,0,19,2 (2ct 0st),0.612
466,SB Joshi (INDIA),1996-2001,69,68,19,19,0,0,19,2 (2ct 0st),0.279
467,H Klaasen (SA),2018-2019,14,14,19,16,3,11,5,4 (3ct 1st),1.357
468,RAS Lakmal (SL),2009-2019,85,83,19,19,0,0,19,1 (1ct 0st),0.228
469,AR McBrine (IRE),2014-2019,42,41,19,19,0,0,19,3 (3ct 0st),0.463
470,Mohammad Sami (PAK),2001-2015,87,86,19,19,0,0,19,2 (2ct 0st),0.220
471,JF Mooney (IRE),2006-2015,64,62,19,19,0,0,19,2 (2ct 0st),0.306
472,DK Morrison (NZ),1987-1996,96,96,19,19,0,0,19,2 (2ct 0st),0.197
473,Naeem Islam (BDESH),2008-2014,59,59,19,19,0,0,19,2 (2ct 0st),0.322
474,Nawroz Mangal (AFG),2009-2016,49,49,19,19,0,0,19,2 (2ct 0st),0.387
475,CJ Nevin (NZ),2000-2003,37,36,19,16,3,14,2,3 (3ct 0st),0.527
476,Rahmat Shah (AFG),2013-2019,70,67,19,19,0,0,19,2 (2ct 0st),0.283
477,SMSM Senanayake (SL),2012-2015,49,48,19,19,0,0,19,3 (3ct 0st),0.395
478,I Sharma (INDIA),2007-2016,80,78,19,19,0,0,19,1 (1ct 0st),0.243
479,MC Snedden (NZ),1980-1990,93,92,19,19,0,0,19,1 (1ct 0st),0.206
480,AO Suji (KENYA),1996-2008,60,60,19,19,0,0,19,2 (2ct 0st),0.316
481,V Yadav (INDIA),1992-1994,19,19,19,12,7,12,0,3 (2ct 1st),1.000
482,Asif Mujtaba (PAK),1986-1996,66,66,18,18,0,0,18,3 (3ct 0st),0.272
483,AR Cusack (IRE),2007-2015,59,55,18,18,0,0,18,2 (2ct 0st),0.327
484,PG Fulton (NZ),2004-2009,49,48,18,18,0,0,18,2 (2ct 0st),0.375
485,IJ Gould (ENG),1983-1983,18,18,18,15,3,15,0,3 (3ct 0st),1.000
486,AC Hudson (SA),1991-1997,89,88,18,18,0,0,18,2 (2ct 0st),0.204
487,AN Kervezee (NL),2006-2012,39,39,18,18,0,0,18,3 (3ct 0st),0.461
488,GF Lawson (AUS),1980-1989,79,79,18,18,0,0,18,2 (2ct 0st),0.227
489,MA Leask (SCOT),2014-2019,34,34,18,18,0,0,18,3 (3ct 0st),0.529
490,S Madan Lal (INDIA),1974-1987,67,65,18,18,0,0,18,2 (2ct 0st),0.276
491,RS Madugalle (SL),1979-1988,63,63,18,18,0,0,18,2 (2ct 0st),0.285
492,JP Maher (AUS),1998-2003,26,26,18,18,0,8,10,3 (3ct 0st),0.692
493,Maninder Singh (INDIA),1983-1993,59,58,18,18,0,0,18,2 (2ct 0st),0.310
494,HJH Marshall (NZ),2003-2007,66,65,18,18,0,0,18,3 (3ct 0st),0.276
495,NO Miller (WI),2008-2018,50,48,18,18,0,0,18,3 (3ct 0st),0.375
496,A Nehra (Asia/INDIA),2001-2011,120,120,18,18,0,0,18,2 (2ct 0st),0.150
497,RR Patel (KENYA),2008-2014,39,39,18,18,0,0,18,2 (2ct 0st),0.461
498,Raqibul Hasan (BDESH),2008-2011,55,55,18,18,0,0,18,2 (2ct 0st),0.327
499,WP Saha (INDIA),2010-2014,9,8,18,17,1,17,0,4 (4ct 0st),2.250
500,SA Thomson (NZ),1990-1996,56,56,18,18,0,0,18,2 (2ct 0st),0.321
501,MA Vermeulen (ZIM),2000-2009,43,43,18,18,0,0,18,3 (3ct 0st),0.418
502,DP Viljoen (ZIM),1997-2001,53,53,18,18,0,0,18,2 (2ct 0st),0.339
503,SC Williams (WI),1994-1999,57,57,18,18,0,0,18,3 (3ct 0st),0.315
504,LJ Wright (ENG),2007-2014,50,50,18,18,0,0,18,2 (2ct 0st),0.360
505,JJ Bumrah (INDIA),2016-2019,58,58,17,17,0,0,17,2 (2ct 0st),0.293
506,JM Davison (CAN),2003-2011,32,32,17,17,0,0,17,2 (2ct 0st),0.531
507,GD Elliott (NZ),2008-2016,83,83,17,17,0,0,17,2 (2ct 0st),0.204
508,TJ Friend (ZIM),2000-2004,51,51,17,17,0,0,17,2 (2ct 0st),0.333
509,Haris Sohail (PAK),2013-2019,41,40,17,17,0,0,17,2 (2ct 0st),0.425
510,IJ Harvey (AUS),1997-2004,73,72,17,17,0,0,17,2 (2ct 0st),0.236
511,MJ Henry (NZ),2014-2019,52,50,17,17,0,0,17,2 (2ct 0st),0.340
512,Khaled Mahmud (BDESH),1998-2006,77,77,17,17,0,0,17,2 (2ct 0st),0.220
513,EB McSweeney (NZ),1986-1987,16,15,17,14,3,14,0,3 (3ct 0st),1.133
514,PJ Ongondo (Afr/KENYA),1999-2011,79,79,17,17,0,0,17,2 (2ct 0st),0.215
515,YK Pathan (INDIA),2008-2012,57,56,17,17,0,0,17,3 (3ct 0st),0.303
516,RW Price (ZIM),2002-2012,102,102,17,17,0,0,17,2 (2ct 0st),0.166
517,AT Rayudu (INDIA),2013-2019,55,53,17,17,0,0,17,2 (2ct 0st),0.320
518,CJ Richards (ENG),1981-1988,22,22,17,16,1,16,0,3 (3ct 0st),0.772
519,TT Samaraweera (SL),1998-2011,53,51,17,17,0,0,17,2 (2ct 0st),0.333
520,MS Sinclair (NZ),2000-2009,54,54,17,17,0,2,15,2 (2ct 0st),0.314
521,Umar Gul (PAK),2003-2016,130,128,17,17,0,0,17,2 (2ct 0st),0.132
522,GM Wood (AUS),1978-1989,83,80,17,17,0,0,17,2 (2ct 0st),0.212
523,Aamer Malik (PAK),1988-1994,24,24,16,13,3,10,3,2 (2ct 0st),0.666
524,CWJ Athey (ENG),1980-1988,31,31,16,16,0,0,16,3 (3ct 0st),0.516
525,JJ Atkinson (HKG),2008-2017,9,9,16,10,6,10,0,4 (4ct 0st),1.777
526,WKM Benjamin (WI),1986-1995,85,85,16,16,0,0,16,1 (1ct 0st),0.188
527,N Chopra (INDIA),1998-2000,39,38,16,16,0,0,16,2 (2ct 0st),0.421
528,Dawlat Zadran (AFG),2011-2019,82,80,16,16,0,0,16,2 (2ct 0st),0.200
529,RL Dias (SL),1979-1987,58,58,16,16,0,0,16,2 (2ct 0st),0.275
530,BN French (ENG),1985-1988,13,13,16,13,3,13,0,3 (3ct 0st),1.230
531,BJ Hodge (AUS),2005-2007,25,25,16,16,0,0,16,2 (2ct 0st),0.640
532,GP Howarth (NZ),1975-1985,70,69,16,16,0,0,16,2 (2ct 0st),0.231
533,APE Knott (ENG),1971-1977,20,19,16,15,1,15,0,4 (4ct 0st),0.842
534,T Mishra (KENYA),2006-2013,42,42,16,16,0,0,16,2 (2ct 0st),0.380
535,DA Murray (WI),1973-1981,10,10,16,16,0,16,0,3 (3ct 0st),1.600
536,TJ Murtagh (IRE),2012-2019,58,57,16,16,0,0,16,1 (1ct 0st),0.280
537,Naved-ul-Hasan (PAK),2003-2010,74,72,16,16,0,0,16,2 (2ct 0st),0.222
538,HM Nicholls (NZ),2015-2019,45,44,16,16,0,0,16,2 (2ct 0st),0.363
539,WB Rankin (ENG/IRE),2007-2019,73,71,16,16,0,0,16,2 (2ct 0st),0.225
540,A Ratra (INDIA),2002-2002,12,12,16,11,5,11,0,3 (2ct 1st),1.333
541,GJ Rennie (ZIM),1996-2003,40,40,16,16,0,0,16,2 (2ct 0st),0.400
542,RD Shah (KENYA),1998-2007,56,56,16,16,0,0,16,2 (2ct 0st),0.285
543,VS Solanki (ENG),2000-2006,51,50,16,16,0,0,16,2 (2ct 0st),0.320
544,A Vala (PNG),2014-2019,27,27,16,16,0,0,16,3 (3ct 0st),0.592
545,Zaheer Abbas (PAK),1974-1985,62,60,16,16,0,0,16,2 (2ct 0st),0.266
546,Anil Dalpat (PAK),1984-1986,15,14,15,13,2,13,0,3 (3ct 0st),1.071
547,MA Atherton (ENG),1990-1998,54,54,15,15,0,0,15,2 (2ct 0st),0.277
548,Basit Ali (PAK),1993-1996,50,49,15,15,0,0,15,2 (2ct 0st),0.306
549,SE Bond (NZ),2002-2010,82,80,15,15,0,0,15,2 (2ct 0st),0.187
550,KJ Coetzer (SCOT),2008-2019,56,55,15,15,0,0,15,2 (2ct 0st),0.272
551,SS Cottrell (WI),2015-2019,25,23,15,15,0,0,15,3 (3ct 0st),0.652
552,SKL de Silva (SL),1997-1997,11,11,15,9,6,9,0,3 (3ct 0st),1.363
553,PS de Villiers (SA),1992-1997,83,82,15,15,0,0,15,2 (2ct 0st),0.182
554,ST Finn (ENG),2011-2017,69,67,15,15,0,0,15,2 (2ct 0st),0.223
555,SO Hetmyer (WI),2017-2019,37,35,15,15,0,3,12,3 (3ct 0st),0.428
556,DT Hondo (ZIM),2001-2005,56,56,15,15,0,0,15,1 (1ct 0st),0.267
557,VG Kambli (INDIA),1991-2000,104,101,15,15,0,0,15,1 (1ct 0st),0.148
558,MD Marshall (WI),1980-1992,136,134,15,15,0,0,15,2 (2ct 0st),0.111
559,BAW Mendis (SL),2008-2015,87,85,15,15,0,0,15,2 (2ct 0st),0.176
560,JA Morkel (Afr/SA),2004-2012,58,58,15,15,0,0,15,2 (2ct 0st),0.258
561,Noor Ali Zadran (AFG),2009-2019,51,49,15,15,0,0,15,2 (2ct 0st),0.306
562,AR Nurse (WI),2016-2019,54,52,15,15,0,0,15,3 (3ct 0st),0.288
563,AA Obanda (KENYA),2007-2014,49,49,15,15,0,0,15,2 (2ct 0st),0.306
564,JL Ontong (Afr/SA),2001-2012,28,27,15,15,0,0,15,2 (2ct 0st),0.555
565,AR Patel (INDIA),2014-2017,38,36,15,15,0,0,15,2 (2ct 0st),0.416
566,Rizwan Cheema (CAN),2008-2013,33,32,15,15,0,0,15,2 (2ct 0st),0.468
567,JD Ryder (NZ),2008-2014,48,48,15,15,0,0,15,2 (2ct 0st),0.312
568,Sohail Tanvir (PAK),2007-2014,62,60,15,15,0,0,15,2 (2ct 0st),0.250
569,CM Spearman (NZ),1995-2001,51,51,15,15,0,0,15,1 (1ct 0st),0.294
570,BC Strang (ZIM),1995-2001,49,48,15,15,0,0,15,2 (2ct 0st),0.312
571,HA Varaiya (KENYA),2006-2014,63,63,15,15,0,0,15,2 (2ct 0st),0.238
572,KJ Wadsworth (NZ),1973-1976,13,13,15,13,2,13,0,3 (3ct 0st),1.153
573,CD Wallace (SCOT),2012-2019,28,28,15,13,2,5,8,4 (4ct 0st),0.535
574,Asad Shafiq (PAK),2010-2017,60,59,14,14,0,0,14,2 (2ct 0st),0.237
575,EAE Baptiste (WI),1983-1990,43,43,14,14,0,0,14,2 (2ct 0st),0.325
576,YS Chahal (INDIA),2016-2019,50,50,14,14,0,0,14,2 (2ct 0st),0.280
577,AC Cummins (CAN/WI),1991-2007,76,75,14,14,0,0,14,2 (2ct 0st),0.186
578,A Dananjaya (SL),2012-2019,36,35,14,14,0,0,14,2 (2ct 0st),0.400
579,DW Fleming (AUS),1994-2001,88,88,14,14,0,0,14,1 (1ct 0st),0.159
580,HA Gomes (WI),1978-1987,83,83,14,14,0,0,14,1 (1ct 0st),0.168
581,PSP Handscomb (AUS),2017-2019,22,22,14,14,0,5,9,3 (3ct 0st),0.636
582,HMRKB Herath (SL),2004-2015,71,69,14,14,0,0,14,2 (2ct 0st),0.202
583,Imran Farhat (PAK),2001-2013,58,58,14,14,0,0,14,1 (1ct 0st),0.241
584,HH Kanitkar (INDIA),1997-2000,34,34,14,14,0,0,14,2 (2ct 0st),0.411
585,Mansoor Akhtar (PAK),1980-1990,41,40,14,14,0,0,14,2 (2ct 0st),0.350
586,LRD Mendis (SL),1975-1989,79,79,14,14,0,0,14,2 (2ct 0st),0.177
587,AA Mulla (CAN),2006-2009,24,24,14,9,5,4,5,2 (2ct 0st),0.583
588,SP Narine (WI),2011-2016,65,65,14,14,0,0,14,2 (2ct 0st),0.215
589,KOA Powell (WI),2009-2018,46,45,14,14,0,0,14,2 (2ct 0st),0.311
590,R Powell (WI),2016-2018,34,33,14,14,0,0,14,2 (2ct 0st),0.424
591,R Rampaul (WI),2003-2015,92,89,14,14,0,0,14,2 (2ct 0st),0.157
592,JR Ratnayeke (SL),1982-1990,78,78,14,14,0,0,14,2 (2ct 0st),0.179
593,Shafiqullah (AFG),2009-2018,24,24,14,11,3,8,3,2 (2ct 0st),0.583
594,JC Tredwell (ENG),2010-2015,45,44,14,14,0,0,14,2 (2ct 0st),0.318
595,IJL Trott (ENG),2009-2013,68,66,14,14,0,0,14,2 (2ct 0st),0.212
596,RR Watson (SCOT),2006-2010,35,34,14,14,0,0,14,2 (2ct 0st),0.411
597,Yasir Hameed (PAK),2003-2007,56,56,14,14,0,0,14,2 (2ct 0st),0.250
598,Aminul Islam (BDESH),1988-2002,39,39,13,13,0,0,13,2 (2ct 0st),0.333
599,HK Badani (INDIA),2000-2004,40,40,13,13,0,0,13,2 (2ct 0st),0.325
600,SW Billings (ENG),2015-2018,15,15,13,13,0,4,9,2 (2ct 0st),0.866
601,PJ Cummins (AUS),2011-2019,58,58,13,13,0,0,13,2 (2ct 0st),0.224
602,PB Dassanayake (SL),1993-1994,16,16,13,9,4,9,0,2 (2ct 0st),0.812
603,ALF de Mel (SL),1982-1987,57,57,13,13,0,0,13,2 (2ct 0st),0.228
604,Dhiman Ghosh (BDESH),2008-2008,14,14,13,9,4,9,0,4 (4ct 0st),0.928
605,Farhad Reza (BDESH),2006-2011,34,34,13,13,0,0,13,2 (2ct 0st),0.382
606,DA Gunawardene (SL),1998-2006,61,61,13,13,0,0,13,2 (2ct 0st),0.213
607,JR Hazlewood (AUS),2010-2018,44,44,13,13,0,0,13,2 (2ct 0st),0.295
608,AJ Hollioake (ENG),1996-1999,35,35,13,13,0,0,13,3 (3ct 0st),0.371
609,MS Kasprowicz (AUS),1995-2005,43,42,13,13,0,0,13,2 (2ct 0st),0.309
610,SM Katich (AUS),2001-2006,45,45,13,13,0,0,13,1 (1ct 0st),0.288
611,UT Khawaja (AUS),2013-2019,40,40,13,13,0,0,13,2 (2ct 0st),0.325
612,E Lewis (WI),2016-2019,43,41,13,13,0,0,13,2 (2ct 0st),0.317
613,NFI McCallum (SCOT),2006-2011,43,42,13,13,0,0,13,2 (2ct 0st),0.309
614,R McLaren (SA),2009-2014,54,52,13,13,0,0,13,1 (1ct 0st),0.250
615,BMAJ Mendis (SL),2010-2019,58,56,13,13,0,0,13,2 (2ct 0st),0.232
616,Mohsin Khan (PAK),1977-1986,75,73,13,13,0,0,13,2 (2ct 0st),0.178
617,Mosaddek Hossain (BDESH),2016-2019,35,34,13,13,0,0,13,2 (2ct 0st),0.382
618,Nasir Jamshed (PAK),2008-2015,48,48,13,13,0,0,13,2 (2ct 0st),0.270
619,HK Olonga (ZIM),1995-2003,50,50,13,13,0,0,13,2 (2ct 0st),0.260
620,JS Patel (NZ),2005-2017,43,42,13,13,0,0,13,1 (1ct 0st),0.309
621,DBL Powell (WI),2002-2009,55,55,13,13,0,0,13,2 (2ct 0st),0.236
622,Rohan Mustafa (UAE),2014-2019,31,31,13,13,0,0,13,2 (2ct 0st),0.419
623,Shahriar Nafees (BDESH),2005-2011,75,75,13,13,0,0,13,2 (2ct 0st),0.173
624,Shoaib Mohammad (PAK),1984-1993,63,62,13,13,0,0,13,2 (2ct 0st),0.209
625,RP Singh (INDIA),2005-2011,58,58,13,13,0,0,13,1 (1ct 0st),0.224
626,DS Smith (WI),2003-2013,47,46,13,13,0,0,13,3 (3ct 0st),0.282
627,RN ten Doeschate (NL),2006-2011,33,33,13,13,0,0,13,2 (2ct 0st),0.393
628,GM Turner (NZ),1973-1983,41,41,13,13,0,0,13,2 (2ct 0st),0.317
629,DNT Zoysa (SL),1997-2007,95,94,13,13,0,0,13,2 (2ct 0st),0.138
630,Amjad Ali (UAE),2008-2015,17,17,12,11,1,4,7,3 (3ct 0st),0.705
631,PK Amre (INDIA),1991-1994,37,36,12,12,0,0,12,2 (2ct 0st),0.333
632,RMH Binny (INDIA),1980-1987,72,70,12,12,0,0,12,2 (2ct 0st),0.171
633,IR Bishop (WI),1988-1997,84,83,12,12,0,0,12,1 (1ct 0st),0.144
634,DE Bollinger (AUS),2009-2011,39,39,12,12,0,0,12,1 (1ct 0st),0.307
635,JM Brearley (ENG),1977-1980,25,25,12,12,0,0,12,2 (2ct 0st),0.480
636,C Carter (HKG),2015-2018,11,11,12,10,2,9,1,3 (3ct 0st),1.090
637,CD Collymore (WI),1999-2007,84,83,12,12,0,0,12,2 (2ct 0st),0.144
638,TLW Cooper (NL),2010-2013,23,23,12,12,0,0,12,2 (2ct 0st),0.521
639,KM Dabengwa (ZIM),2005-2010,37,37,12,12,0,0,12,2 (2ct 0st),0.324
640,JWM Dalrymple (ENG),2006-2007,27,27,12,12,0,0,12,2 (2ct 0st),0.444
641,KSC de Silva (SL),1996-2000,38,37,12,12,0,0,12,2 (2ct 0st),0.324
642,J Dyson (AUS),1980-1983,29,29,12,12,0,0,12,3 (3ct 0st),0.413
643,BA Edgar (NZ),1978-1986,64,63,12,12,0,0,12,2 (2ct 0st),0.190
644,CN Evans (ZIM),1992-2002,53,52,12,12,0,0,12,2 (2ct 0st),0.230
645,NA Foster (ENG),1984-1989,48,48,12,12,0,0,12,2 (2ct 0st),0.250
646,Gulbadin Naib (AFG),2011-2019,64,62,12,12,0,0,12,1 (1ct 0st),0.193
647,MD Gunathilaka (SL),2015-2019,38,37,12,12,0,0,12,2 (2ct 0st),0.324
648,Hasan Ali (PAK),2016-2019,53,52,12,12,0,0,12,2 (2ct 0st),0.230
649,TM Head (AUS),2016-2018,42,42,12,12,0,0,12,2 (2ct 0st),0.285
650,MJ Horne (NZ),1997-2002,50,49,12,12,0,0,12,2 (2ct 0st),0.244
651,Imad Wasim (PAK),2015-2019,53,52,12,12,0,0,12,1 (1ct 0st),0.230
652,CA Ingram (SA),2010-2013,31,31,12,12,0,0,12,2 (2ct 0st),0.387
653,Javed Omar (BDESH),1995-2007,59,59,12,12,0,0,12,2 (2ct 0st),0.203
654,SG Law (AUS),1994-1999,54,54,12,12,0,0,12,2 (2ct 0st),0.222
655,DA Marillier (ZIM),2000-2003,48,48,12,12,0,0,12,2 (2ct 0st),0.250
656,AK Markram (SA),2017-2019,26,25,12,12,0,0,12,3 (3ct 0st),0.480
657,T Maruma (ZIM),2007-2019,21,21,12,12,0,0,12,3 (3ct 0st),0.571
658,SF Mire (ZIM),2014-2019,47,47,12,12,0,0,12,1 (1ct 0st),0.255
659,HS Modi (KENYA),1996-2006,63,63,12,12,0,0,12,2 (2ct 0st),0.190
660,J Mubarak (SL),2002-2013,40,40,12,12,0,0,12,2 (2ct 0st),0.300
661,Mustafizur Rahman (BDESH),2015-2019,56,55,12,12,0,0,12,2 (2ct 0st),0.218
662,Nadeem Ahmed (HKG),2004-2018,25,25,12,12,0,0,12,2 (2ct 0st),0.480
663,MO Odumbe (KENYA),1996-2003,61,61,12,12,0,0,12,2 (2ct 0st),0.196
664,JM Parker (NZ),1974-1981,24,24,12,11,1,0,11,3 (3ct 0st),0.500
665,WD Parnell (SA),2009-2017,65,62,12,12,0,0,12,2 (2ct 0st),0.193
666,DA Reeve (ENG),1991-1996,29,29,12,12,0,0,12,3 (3ct 0st),0.413
667,JA Rennie (ZIM),1993-2000,44,44,12,12,0,0,12,2 (2ct 0st),0.272
668,PM Seelaar (NL),2006-2019,41,41,12,12,0,0,12,2 (2ct 0st),0.292
669,Shaiman Anwar (UAE),2014-2019,40,40,12,12,0,0,12,2 (2ct 0st),0.300
670,MP Stoinis (AUS),2015-2019,41,41,12,12,0,0,12,1 (1ct 0st),0.292
671,C White (ENG),1994-2003,51,50,12,12,0,0,12,1 (1ct 0st),0.240
672,CJ Anderson (NZ),2013-2017,49,48,11,11,0,0,11,2 (2ct 0st),0.229
673,Babar Hayat (HKG),2014-2018,22,22,11,11,0,0,11,2 (2ct 0st),0.500
674,L Balaji (INDIA),2002-2009,30,30,11,11,0,0,11,2 (2ct 0st),0.366
675,AM Blignaut (ZIM),1999-2010,54,54,11,11,0,0,11,2 (2ct 0st),0.203
676,AC Botha (IRE),2006-2011,42,40,11,11,0,0,11,2 (2ct 0st),0.275
677,EA Brandes (ZIM),1987-1999,59,59,11,11,0,0,11,1 (1ct 0st),0.186
678,CR Brathwaite (WI),2011-2019,44,42,11,11,0,0,11,1 (1ct 0st),0.261
679,R Clarke (ENG),2003-2006,20,20,11,11,0,0,11,3 (3ct 0st),0.550
680,RDB Croft (ENG),1996-2001,50,49,11,11,0,0,11,1 (1ct 0st),0.224
681,AC Dale (AUS),1997-2000,30,30,11,11,0,0,11,1 (1ct 0st),0.366
682,C de Grandhomme (NZ),2012-2019,38,38,11,11,0,0,11,2 (2ct 0st),0.289
683,J Edness (BMUDA),2007-2008,11,11,11,7,4,7,0,3 (2ct 1st),1.000
684,D Ganga (WI),1999-2006,35,35,11,11,0,0,11,2 (2ct 0st),0.314
685,RR Hendricks (SA),2018-2019,18,18,11,11,0,0,11,3 (3ct 0st),0.611
686,DW Hookes (AUS),1977-1986,39,37,11,11,0,0,11,2 (2ct 0st),0.297
687,KM Jarvis (ZIM),2009-2019,49,49,11,11,0,0,11,2 (2ct 0st),0.224
688,PN Kirsten (SA),1991-1994,40,40,11,11,0,0,11,2 (2ct 0st),0.275
689,P Kumar (INDIA),2007-2012,68,67,11,11,0,0,11,2 (2ct 0st),0.164
690,CK Langeveldt (SA),2001-2010,72,71,11,11,0,0,11,1 (1ct 0st),0.154
691,RT Latham (NZ),1990-1994,33,33,11,11,0,0,11,2 (2ct 0st),0.333
692,XM Marshall (USA/WI),2005-2019,29,28,11,11,0,0,11,2 (2ct 0st),0.392
693,Mehidy Hasan Miraz (BDESH),2017-2019,38,37,11,11,0,0,11,3 (3ct 0st),0.297
694,Mohammad Irfan (PAK),2010-2016,60,60,11,11,0,0,11,2 (2ct 0st),0.183
695,CB Mpofu (ZIM),2004-2019,83,82,11,11,0,0,11,1 (1ct 0st),0.134
696,HG Munsey (SCOT),2017-2019,22,22,11,11,0,0,11,2 (2ct 0st),0.500
697,BA Murphy (ZIM),2000-2003,31,31,11,11,0,0,11,2 (2ct 0st),0.354
698,D Murphy (SCOT),2013-2013,8,8,11,8,3,8,0,5 (3ct 2st),1.375
699,TK Musakanda (ZIM),2016-2018,15,15,11,11,0,0,11,2 (2ct 0st),0.733
700,P Mustard (ENG),2007-2008,10,10,11,9,2,9,0,2 (2ct 0st),1.100
701,F Mutizwa (ZIM),2009-2011,17,17,11,9,2,8,1,3 (3ct 0st),0.647
702,RJ Nicol (NZ),2011-2013,22,22,11,11,0,0,11,2 (2ct 0st),0.500
703,SB O'Connor (NZ),1997-2000,38,38,11,11,0,0,11,2 (2ct 0st),0.289
704,H Osinde (CAN),2006-2013,42,41,11,11,0,0,11,2 (2ct 0st),0.268
705,MM Patel (INDIA),2006-2011,70,68,11,11,0,0,11,2 (2ct 0st),0.161
706,SM Patil (INDIA),1980-1986,45,44,11,11,0,0,11,2 (2ct 0st),0.250
707,SP Patil (UAE),2014-2015,13,13,11,8,3,8,0,3 (3ct 0st),0.846
708,AL Phehlukwayo (SA),2016-2019,52,51,11,11,0,0,11,2 (2ct 0st),0.215
709,DR Pringle (ENG),1982-1993,44,44,11,11,0,0,11,2 (2ct 0st),0.250
710,CPH Ramanayake (SL),1986-1995,62,62,11,11,0,0,11,2 (2ct 0st),0.177
711,RJ Ratnayake (SL),1982-1993,70,70,11,11,0,0,11,2 (2ct 0st),0.157
712,SJ Rhodes (ENG),1989-1995,9,9,11,9,2,9,0,4 (3ct 1st),1.222
713,SJ Rixon (AUS),1978-1985,6,6,11,9,2,9,0,4 (2ct 2st),1.833
714,JA Rudolph (Afr/SA),2003-2006,45,45,11,11,0,0,11,2 (2ct 0st),0.244
715,AD Russell (WI),2011-2019,56,56,11,11,0,0,11,1 (1ct 0st),0.196
716,Sanwar Hossain (BDESH),1998-2003,27,27,11,11,0,0,11,2 (2ct 0st),0.407
717,MA Suji (KENYA),1996-2006,64,64,11,11,0,0,11,2 (2ct 0st),0.171
718,Tahir Naqqash (PAK),1980-1985,40,38,11,11,0,0,11,2 (2ct 0st),0.289
719,TP Ura (PNG),2014-2019,26,26,11,11,0,0,11,2 (2ct 0st),0.423
720,DLS van Bunge (NL),2002-2013,37,37,11,11,0,0,11,2 (2ct 0st),0.297
721,MN van Wyk (SA),2003-2015,17,17,11,10,1,9,1,4 (4ct 0st),0.647
722,PA Wallace (WI),1991-2000,33,32,11,11,0,0,11,2 (2ct 0st),0.343
723,MR Whitney (AUS),1983-1993,38,38,11,11,0,0,11,3 (3ct 0st),0.289
724,MA Wood (ENG),2015-2019,51,50,11,11,0,0,11,2 (2ct 0st),0.220
725,Ahmed Raza (UAE),2014-2018,25,25,10,10,0,0,10,2 (2ct 0st),0.400
726,Amir Hamza (AFG),2012-2017,31,31,10,10,0,0,10,2 (2ct 0st),0.322
727,Anamul Haque (BDESH),2012-2019,38,38,10,10,0,6,4,3 (3ct 0st),0.263
728,SD Anurasiri (SL),1986-1994,45,45,10,10,0,0,10,2 (2ct 0st),0.222
729,Arshad Khan (PAK),1993-2006,58,57,10,10,0,0,10,2 (2ct 0st),0.175
730,SFAF Bacchus (WI),1978-1983,29,29,10,10,0,0,10,2 (2ct 0st),0.344
731,BC Broad (ENG),1987-1988,34,34,10,10,0,0,10,1 (1ct 0st),0.294
732,RK Chauhan (INDIA),1993-1997,35,34,10,10,0,0,10,1 (1ct 0st),0.294
733,DT Christian (AUS),2012-2014,19,19,10,10,0,0,10,2 (2ct 0st),0.526
734,SR Clark (AUS),2005-2009,39,39,10,10,0,0,10,2 (2ct 0st),0.256
735,SB Doull (NZ),1992-2000,42,42,10,10,0,0,10,2 (2ct 0st),0.238
736,Fawad Alam (PAK),2007-2015,38,38,10,10,0,0,10,2 (2ct 0st),0.263
737,LH Ferguson (NZ),2016-2019,36,36,10,10,0,0,10,1 (1ct 0st),0.277
738,JN Gillespie (AUS),1996-2005,97,97,10,10,0,0,10,1 (1ct 0st),0.103
739,DAS Gunaratne (SL),2016-2019,31,30,10,10,0,0,10,2 (2ct 0st),0.333
740,RM Haq (SCOT),2006-2015,54,52,10,10,0,0,10,2 (2ct 0st),0.192
741,SJ Harmison (ENG),2002-2009,58,58,10,10,0,0,10,1 (1ct 0st),0.172
742,BW Hilfenhaus (AUS),2007-2012,25,25,10,10,0,0,10,2 (2ct 0st),0.400
743,TG Hogan (AUS),1983-1984,16,15,10,10,0,0,10,2 (2ct 0st),0.666
744,Iftikhar Anjum (PAK),2004-2010,62,61,10,10,0,0,10,3 (3ct 0st),0.163
745,Ihsanullah (AFG),2017-2018,16,16,10,10,0,0,10,3 (3ct 0st),0.625
746,Javed Ahmadi (AFG),2010-2019,42,39,10,10,0,0,10,1 (1ct 0st),0.256
747,LM Jongwe (ZIM),2014-2016,22,22,10,10,0,0,10,3 (3ct 0st),0.454
748,M Kartik (INDIA),2002-2007,37,37,10,10,0,0,10,1 (1ct 0st),0.270
749,R Lamba (INDIA),1986-1989,32,32,10,10,0,0,10,1 (1ct 0st),0.312
750,RDM Leverock (BMUDA),2006-2009,32,32,10,10,0,0,10,2 (2ct 0st),0.312
751,DK Lillee (AUS),1972-1983,63,63,10,10,0,0,10,2 (2ct 0st),0.158
752,DR Lockhart (SCOT),2006-2010,14,14,10,10,0,9,1,3 (3ct 0st),0.714
753,CR Matthews (SA),1991-1997,56,55,10,10,0,0,10,2 (2ct 0st),0.181
754,Mohammad Salman (PAK),2011-2011,7,7,10,8,2,8,0,4 (4ct 0st),1.428
755,DS Mohanty (INDIA),1997-2001,45,44,10,10,0,0,10,2 (2ct 0st),0.227
756,Saleem Elahi (PAK),1995-2004,48,47,10,10,0,0,10,2 (2ct 0st),0.212
757,Shabbir Ahmed (PAK),1999-2005,32,32,10,10,0,0,10,2 (2ct 0st),0.312
758,SM Sharif (SCOT),2011-2019,42,42,10,10,0,0,10,2 (2ct 0st),0.238
759,Tauseef Ahmed (PAK),1982-1990,70,68,10,10,0,0,10,1 (1ct 0st),0.147
760,KL Tucker (BMUDA),2006-2007,12,12,10,9,1,8,1,4 (4ct 0st),0.833
761,AC Waller (ZIM),1987-1997,39,38,10,10,0,0,10,2 (2ct 0st),0.263
762,KD Walters (AUS),1971-1981,28,28,10,10,0,0,10,3 (3ct 0st),0.357
763,CAK Walton (WI),2009-2017,9,9,10,9,1,6,3,4 (4ct 0st),1.111
764,MH Yardy (ENG),2006-2011,28,28,10,10,0,0,10,2 (2ct 0st),0.357
765,Yashpal Sharma (INDIA),1978-1985,42,42,10,10,0,0,10,1 (1ct 0st),0.238
766,A Zampa (AUS),2016-2019,48,48,10,10,0,0,10,1 (1ct 0st),0.208
767,CJA Amini (PNG),2014-2019,15,15,9,9,0,0,9,1 (1ct 0st),0.600
768,HS Baidwan (CAN),2008-2014,32,32,9,9,0,0,9,1 (1ct 0st),0.281
769,HMCM Bandara (SL),2006-2010,31,30,9,9,0,0,9,3 (3ct 0st),0.300
770,SJ Benn (WI),2008-2016,47,46,9,9,0,0,9,1 (1ct 0st),0.195
771,NT Broom (NZ),2009-2017,39,39,9,9,0,0,9,2 (2ct 0st),0.230
772,AR Caddick (ENG),1993-2003,54,53,9,9,0,0,9,2 (2ct 0st),0.169
773,LOB Cann (BMUDA),2006-2009,26,26,9,9,0,0,9,2 (2ct 0st),0.346
774,PP Chawla (INDIA),2007-2011,25,25,9,9,0,0,9,3 (3ct 0st),0.360
775,JH Davey (SCOT),2010-2017,29,28,9,9,0,0,9,2 (2ct 0st),0.321
776,N Deonarine (WI),2005-2015,31,31,9,9,0,0,9,2 (2ct 0st),0.290
777,SI de Saram (SL),1999-2001,15,15,9,9,0,0,9,2 (2ct 0st),0.600
778,MA Ealham (ENG),1996-2001,64,63,9,9,0,0,9,1 (1ct 0st),0.142
779,S Elworthy (SA),1998-2002,39,38,9,9,0,0,9,3 (3ct 0st),0.236
780,Hashmatullah Shahidi (AFG),2013-2019,39,38,9,9,0,0,9,1 (1ct 0st),0.236
781,IA Karim (KENYA),2011-2014,9,9,9,8,1,5,3,2 (2ct 0st),1.000
782,CM Kuggeleijn (NZ),1988-1989,16,16,9,9,0,0,9,2 (2ct 0st),0.562
783,NC McGarrell (WI),1998-2001,17,17,9,9,0,0,9,2 (2ct 0st),0.529
784,RD McCann (IRE),2010-2010,8,8,9,9,0,9,0,3 (3ct 0st),1.125
785,SS McKechnie (HKG),2017-2018,8,8,9,8,1,7,1,4 (3ct 1st),1.125
786,Mohammad Wasim (PAK),1996-2000,25,25,9,9,0,0,9,2 (2ct 0st),0.360
787,CH Morris (SA),2013-2019,42,40,9,9,0,0,9,1 (1ct 0st),0.225
788,Muhammad Usman (UAE),2016-2019,27,27,9,9,0,0,9,3 (3ct 0st),0.333
789,T Mupariwa (ZIM),2004-2016,40,40,9,9,0,0,9,1 (1ct 0st),0.225
790,Nizakat Khan (HKG),2014-2018,20,20,9,9,0,0,9,2 (2ct 0st),0.450
791,SJ Palframan (SA),1996-1996,7,7,9,9,0,9,0,3 (3ct 0st),1.285
792,T Panyangara (ZIM),2004-2016,65,65,9,9,0,0,9,2 (2ct 0st),0.138
793,BP Patterson (WI),1986-1993,59,58,9,9,0,0,9,1 (1ct 0st),0.155
794,AD Poynter (IRE),2008-2014,19,18,9,9,0,0,9,2 (2ct 0st),0.500
795,Rajin Saleh (BDESH),2003-2006,43,43,9,9,0,0,9,2 (2ct 0st),0.209
796,GM Ritchie (AUS),1982-1987,44,44,9,9,0,0,9,2 (2ct 0st),0.204
797,AM Samad (CAN),2003-2009,27,26,9,9,0,0,9,2 (2ct 0st),0.346
798,Simi Singh (IRE),2017-2019,15,15,9,9,0,0,9,2 (2ct 0st),0.600
799,MJ Slater (AUS),1993-1997,42,42,9,9,0,0,9,2 (2ct 0st),0.214
800,RS Sodhi (INDIA),2000-2002,18,18,9,9,0,0,9,2 (2ct 0st),0.500
801,Sohaib Maqsood (PAK),2013-2016,26,26,9,9,0,0,9,2 (2ct 0st),0.346
802,Sohrawordi Shuvo (BDESH),2010-2011,17,17,9,9,0,0,9,2 (2ct 0st),0.529
803,Taufeeq Umar (PAK),2001-2011,22,22,9,9,0,0,9,1 (1ct 0st),0.409
804,JR Thomson (AUS),1975-1985,50,50,9,9,0,0,9,2 (2ct 0st),0.180
805,LL Tsotsobe (SA),2009-2013,61,60,9,9,0,0,9,2 (2ct 0st),0.150
806,JJ Tucker (BMUDA),2006-2009,26,26,9,9,0,0,9,2 (2ct 0st),0.346
807,HE van der Dussen (SA),2019-2019,18,17,9,9,0,0,9,2 (2ct 0st),0.529
808,JNT Vare (PNG),2014-2018,9,9,9,6,3,6,0,3 (3ct 0st),1.000
809,M Vijay (INDIA),2010-2015,17,17,9,9,0,0,9,2 (2ct 0st),0.529
810,W Watson (NZ),1986-1994,61,61,9,9,0,0,9,1 (1ct 0st),0.147
811,AR Adams (NZ),2001-2007,42,41,8,8,0,0,8,2 (2ct 0st),0.195
812,Akram Khan (BDESH),1988-2003,44,44,8,8,0,0,8,2 (2ct 0st),0.181
813,Amjad Javed (UAE),2008-2017,15,15,8,8,0,0,8,1 (1ct 0st),0.533
814,Azhar Ali (PAK),2011-2018,53,52,8,8,0,0,8,1 (1ct 0st),0.153
815,GS Ballance (ENG),2013-2015,16,16,8,8,0,0,8,2 (2ct 0st),0.500
816,D Bau (PNG),2016-2017,10,10,8,6,2,5,1,3 (2ct 1st),0.800
817,S Bau (PNG),2016-2019,21,21,8,8,0,0,8,1 (1ct 0st),0.380
818,ID Blackwell (ENG),2002-2006,34,34,8,8,0,0,8,2 (2ct 0st),0.235
819,JAR Blain (SCOT),1999-2009,33,32,8,8,0,0,8,1 (1ct 0st),0.250
820,MG Burgess (NZ),1973-1981,26,26,8,8,0,0,8,2 (2ct 0st),0.307
821,RP Burl (ZIM),2017-2019,18,18,8,8,0,0,8,2 (2ct 0st),0.444
822,IG Butler (NZ),2002-2010,26,25,8,8,0,0,8,2 (2ct 0st),0.320
823,TM Chappell (AUS),1980-1983,20,20,8,8,0,0,8,2 (2ct 0st),0.400
824,FRJ Coleman (SCOT),2013-2015,16,15,8,8,0,0,8,3 (3ct 0st),0.533
825,PT Collins (WI),1999-2005,30,30,8,8,0,0,8,2 (2ct 0st),0.266
826,MD Dai (PNG),2014-2018,18,18,8,8,0,0,8,2 (2ct 0st),0.444
827,SM Davies (ENG),2009-2011,8,8,8,8,0,8,0,2 (2ct 0st),1.000
828,S Dhaniram (CAN),2006-2010,44,43,8,8,0,0,8,1 (1ct 0st),0.186
829,Enamul Haque jnr (BDESH),2005-2009,10,10,8,8,0,0,8,2 (2ct 0st),0.800
830,ADS Fletcher (WI),2008-2016,25,25,8,5,3,2,3,3 (1ct 2st),0.320
831,Hannan Sarkar (BDESH),2002-2004,20,20,8,8,0,2,6,2 (2ct 0st),0.400
832,RM Hogg (AUS),1979-1985,71,69,8,8,0,0,8,1 (1ct 0st),0.115
833,RIC Holder (WI),1993-1997,37,37,8,8,0,0,8,3 (3ct 0st),0.216
834,RK Illingworth (ENG),1991-1996,25,25,8,8,0,0,8,2 (2ct 0st),0.320
835,BP Julian (AUS),1993-1999,25,25,8,8,0,0,8,2 (2ct 0st),0.320
836,Junaid Khan (PAK),2011-2019,76,76,8,8,0,0,8,1 (1ct 0st),0.105
837,AI Kallicharran (WI),1973-1981,31,31,8,8,0,0,8,2 (2ct 0st),0.258
838,FDM Karunaratne (SL),2011-2019,28,28,8,8,0,0,8,1 (1ct 0st),0.285
839,SC Khanna (INDIA),1979-1984,10,9,8,4,4,4,0,3 (1ct 2st),0.888
840,GF Labrooy (SL),1986-1992,44,44,8,8,0,0,8,1 (1ct 0st),0.181
841,W Larkins (ENG),1979-1991,25,25,8,8,0,0,8,1 (1ct 0st),0.320
842,NAM McLean (WI),1996-2003,45,45,8,8,0,0,8,2 (2ct 0st),0.177
843,Manjural Islam (BDESH),1999-2003,34,34,8,8,0,0,8,1 (1ct 0st),0.235
844,VJ Marks (ENG),1980-1988,34,34,8,8,0,0,8,1 (1ct 0st),0.235
845,BJ McCarthy (IRE),2016-2019,27,27,8,8,0,0,8,2 (2ct 0st),0.296
846,Mirwais Ashraf (AFG),2009-2016,46,45,8,8,0,0,8,2 (2ct 0st),0.177
847,Mohammad Akram (PAK),1995-2000,23,21,8,8,0,0,8,2 (2ct 0st),0.380
848,Mohammad Amir (PAK),2009-2019,61,60,8,8,0,0,8,2 (2ct 0st),0.133
849,S Mukuddem (BMUDA),2006-2007,20,20,8,8,0,0,8,1 (1ct 0st),0.400
850,AD Mullally (ENG),1996-2001,50,49,8,8,0,0,8,2 (2ct 0st),0.163
851,CM Old (ENG),1973-1981,32,32,8,8,0,0,8,2 (2ct 0st),0.250
852,DR Parry (WI),1978-1980,6,6,8,8,0,0,8,2 (2ct 0st),1.333
853,KR Pushpakumara (SL),1994-1999,31,31,8,8,0,0,8,3 (3ct 0st),0.258
854,KL Rahul (INDIA),2016-2019,23,23,8,8,0,0,8,2 (2ct 0st),0.347
855,EC Rainsford (ZIM),2004-2010,39,39,8,8,0,0,8,2 (2ct 0st),0.205
856,SLV Raju (INDIA),1990-1996,53,52,8,8,0,0,8,1 (1ct 0st),0.153
857,MR Ramprakash (ENG),1991-2001,18,18,8,8,0,0,8,2 (2ct 0st),0.444
858,MJR Rindel (SA),1994-1999,22,22,8,8,0,0,8,2 (2ct 0st),0.363
859,IH Romaine (BMUDA),2006-2009,35,35,8,8,0,0,8,2 (2ct 0st),0.228
860,Sarfraz Nawaz (PAK),1973-1984,45,45,8,8,0,0,8,1 (1ct 0st),0.177
861,TL Seifert (NZ),2019-2019,3,3,8,7,1,7,0,4 (4ct 0st),2.666
862,Shadab Khan (PAK),2017-2019,43,43,8,8,0,0,8,1 (1ct 0st),0.186
863,Shafiul Islam (BDESH),2010-2019,59,59,8,8,0,0,8,2 (2ct 0st),0.135
864,L Siaka (PNG),2014-2019,25,25,8,8,0,0,8,2 (2ct 0st),0.320
865,SB Smith (AUS),1983-1985,28,27,8,8,0,0,8,1 (1ct 0st),0.296
866,Syed Rasel (BDESH),2005-2010,52,52,8,8,0,0,8,2 (2ct 0st),0.153
867,SW Tait (AUS),2007-2011,35,35,8,8,0,0,8,2 (2ct 0st),0.228
868,Tapash Baisya (BDESH),2002-2007,56,56,8,8,0,0,8,1 (1ct 0st),0.142
869,SR Thompson (IRE),2013-2017,20,19,8,8,0,0,8,1 (1ct 0st),0.421
870,LJ Tucker (IRE),2019-2019,5,5,8,7,1,6,1,3 (3ct 0st),1.600
871,N Vanua (PNG),2014-2019,23,23,8,8,0,0,8,2 (2ct 0st),0.347
872,MRJ Veletta (AUS),1987-1989,20,20,8,8,0,1,7,3 (3ct 0st),0.400
873,DM Wellham (AUS),1981-1987,17,17,8,8,0,0,8,2 (2ct 0st),0.470
874,LR Williams (WI),1996-2001,15,15,8,8,0,0,8,2 (2ct 0st),0.533
875,KJ Wright (AUS),1979-1979,5,5,8,8,0,8,0,2 (2ct 0st),1.600
876,KJ Abbott (SA),2013-2016,28,27,7,7,0,0,7,2 (2ct 0st),0.259
877,Abdur Rehman (PAK),2006-2014,31,31,7,7,0,0,7,2 (2ct 0st),0.225
878,PR Adams (SA),1996-2003,24,24,7,7,0,0,7,2 (2ct 0st),0.291
879,Al Sahariar (BDESH),1999-2003,29,29,7,7,0,0,7,2 (2ct 0st),0.241
880,Asif Iqbal (PAK),1973-1979,10,10,7,7,0,0,7,2 (2ct 0st),0.700
881,KBJ Azad (INDIA),1980-1986,25,24,7,7,0,0,7,2 (2ct 0st),0.291
882,GEF Barnett (CAN),2006-2010,22,22,7,7,0,0,7,1 (1ct 0st),0.318
883,DE Bernard (WI),2003-2010,20,19,7,7,0,0,7,1 (1ct 0st),0.368
884,IS Billcliff (CAN),2003-2009,19,19,7,7,0,0,7,2 (2ct 0st),0.368
885,D Bishoo (WI),2011-2019,42,41,7,7,0,0,7,1 (1ct 0st),0.170
886,GS Blewett (AUS),1995-1999,32,32,7,7,0,0,7,2 (2ct 0st),0.218
887,JL Carter (WI),2015-2019,33,32,7,7,0,0,7,2 (2ct 0st),0.218
888,NM Coulter-Nile (AUS),2013-2019,32,32,7,7,0,0,7,1 (1ct 0st),0.218
889,CD de Lange (SCOT),2016-2017,13,13,7,7,0,0,7,3 (3ct 0st),0.538
890,TBM de Leede (NL),1996-2007,29,29,7,7,0,0,7,2 (2ct 0st),0.241
891,JL Denly (ENG),2009-2019,13,13,7,7,0,0,7,2 (2ct 0st),0.538
892,AIC Dodemaide (AUS),1988-1993,24,24,7,7,0,0,7,2 (2ct 0st),0.291
893,CJ Ferguson (AUS),2009-2011,30,29,7,7,0,0,7,2 (2ct 0st),0.241
894,SR Gillespie (NZ),1986-1988,19,19,7,7,0,0,7,2 (2ct 0st),0.368
895,G Goudie (SCOT),2008-2013,16,16,7,7,0,0,7,2 (2ct 0st),0.437
896,ZE Green (NAM),2019-2019,5,5,7,5,2,5,0,5 (5ct 0st),1.400
897,AW Greig (ENG),1972-1977,22,21,7,7,0,0,7,3 (3ct 0st),0.333
898,R Gunasekera (CAN),2008-2014,19,19,7,7,0,0,7,2 (2ct 0st),0.368
899,GM Hamilton (SCOT),1999-2010,38,38,7,6,1,0,6,1 (1ct 0st),0.184
900,AS Hansra (CAN),2010-2014,24,24,7,7,0,0,7,1 (1ct 0st),0.291
901,MN Hart (NZ),1994-2002,13,13,7,7,0,0,7,2 (2ct 0st),0.538
902,DL Hemp (BMUDA),2006-2009,22,22,7,7,0,0,7,3 (3ct 0st),0.318
903,AG Huckle (ZIM),1997-1999,19,19,7,7,0,0,7,2 (2ct 0st),0.368
904,Humayun Farhat (PAK),2001-2001,5,5,7,4,3,4,0,3 (3ct 0st),1.400
905,KAD Hurdle (BMUDA),2006-2007,19,19,7,7,0,0,7,1 (1ct 0st),0.368
906,Imam-ul-Haq (PAK),2017-2019,37,36,7,7,0,0,7,1 (1ct 0st),0.194
907,Jahurul Islam (BDESH),2010-2013,14,14,7,7,0,4,3,3 (3ct 0st),0.500
908,NG Jones (IRE),2010-2011,14,14,7,7,0,0,7,2 (2ct 0st),0.500
909,S Randiv (SL),2009-2016,31,30,7,7,0,0,7,1 (1ct 0st),0.233
910,SHT Kandamby (SL),2004-2014,39,38,7,7,0,0,7,2 (2ct 0st),0.184
911,NR Kumar (CAN),2010-2014,16,16,7,7,0,0,7,2 (2ct 0st),0.437
912,RN Lewis (WI),1997-2009,28,28,7,7,0,0,7,1 (1ct 0st),0.250
913,NM Lyon (AUS),2012-2019,29,29,7,7,0,0,7,2 (2ct 0st),0.241
914,PD McGlashan (NZ),2009-2009,4,4,7,7,0,7,0,3 (3ct 0st),1.750
915,CJ McKay (AUS),2009-2014,59,59,7,7,0,0,7,3 (3ct 0st),0.118
916,CS Martin (NZ),2001-2008,20,19,7,7,0,0,7,1 (1ct 0st),0.368
917,SW Masakadza (ZIM),2010-2014,16,16,7,7,0,0,7,3 (3ct 0st),0.437
918,Mehrab Hossain jnr (BDESH),2006-2009,18,18,7,7,0,0,7,1 (1ct 0st),0.388
919,VV Morea (PNG),2014-2018,13,13,7,7,0,0,7,2 (2ct 0st),0.538
920,B Muzarabani (ZIM),2018-2018,18,18,7,7,0,0,7,2 (2ct 0st),0.388
921,Naimur Rahman (BDESH),1995-2002,29,29,7,7,0,0,7,2 (2ct 0st),0.241
922,J Nyumbu (ZIM),2014-2015,19,19,7,7,0,0,7,2 (2ct 0st),0.368
923,NN Odhiambo (KENYA),2006-2014,69,69,7,7,0,0,7,1 (1ct 0st),0.101
924,PP Ojha (INDIA),2008-2012,18,18,7,7,0,0,7,3 (3ct 0st),0.388
925,E Otieno (KENYA),2007-2014,26,26,7,7,0,0,7,2 (2ct 0st),0.269
926,RR Pant (INDIA),2018-2019,12,12,7,7,0,3,4,2 (2ct 0st),0.583
927,BJ Patel (KENYA),2001-2006,31,31,7,7,0,0,7,1 (1ct 0st),0.225
928,H Patel (CAN),2009-2013,23,22,7,7,0,0,7,2 (2ct 0st),0.318
929,SR Patel (ENG),2008-2013,36,36,7,7,0,0,7,2 (2ct 0st),0.194
930,KMA Paul (WI),2018-2019,12,12,7,7,0,0,7,2 (2ct 0st),0.583
931,NS Poonia (SCOT),2006-2009,21,20,7,7,0,0,7,2 (2ct 0st),0.350
932,S Prasanna (SL),2011-2019,40,40,7,7,0,0,7,1 (1ct 0st),0.175
933,C Pringle (NZ),1990-1995,64,64,7,7,0,0,7,1 (1ct 0st),0.109
934,SMA Priyanjan (SL),2013-2015,23,23,7,7,0,0,7,1 (1ct 0st),0.304
935,DJ Reekers (NL),2006-2009,19,19,7,7,0,0,7,2 (2ct 0st),0.368
936,KW Richardson (AUS),2013-2019,22,22,7,7,0,0,7,2 (2ct 0st),0.318
937,BG Rogers (ZIM),2002-2005,15,15,7,7,0,0,7,1 (1ct 0st),0.466
938,PADLR Sandakan (SL),2016-2019,21,21,7,7,0,0,7,2 (2ct 0st),0.333
939,V Shankar (INDIA),2019-2019,12,12,7,7,0,0,7,1 (1ct 0st),0.583
940,C Sharma (INDIA),1983-1994,65,64,7,7,0,0,7,1 (1ct 0st),0.109
941,SK Sharma (INDIA),1988-1990,23,23,7,7,0,0,7,2 (2ct 0st),0.304
942,M Sheikh (KENYA),1997-2000,21,21,7,7,0,0,7,1 (1ct 0st),0.333
943,L Sivaramakrishnan (INDIA),1985-1987,16,16,7,7,0,0,7,3 (3ct 0st),0.437
944,GC Small (ENG),1987-1992,53,53,7,7,0,0,7,2 (2ct 0st),0.132
945,RP Snell (SA),1991-1996,42,42,7,7,0,0,7,1 (1ct 0st),0.166
946,IS Sodhi (NZ),2015-2019,31,30,7,7,0,0,7,2 (2ct 0st),0.233
947,Sohag Gazi (BDESH),2012-2014,20,20,7,7,0,0,7,2 (2ct 0st),0.350
948,TB Sole (SCOT),2018-2019,10,10,7,7,0,0,7,2 (2ct 0st),0.700
949,S Sreesanth (INDIA),2005-2011,53,52,7,7,0,0,7,1 (1ct 0st),0.134
950,WF Stelling (NL),2006-2007,15,15,7,7,0,0,7,1 (1ct 0st),0.466
951,ES Szwarczynski (NL),2006-2014,41,41,7,7,0,0,7,1 (1ct 0st),0.170
952,Taskin Ahmed (BDESH),2014-2017,32,31,7,7,0,0,7,1 (1ct 0st),0.225
953,CJ Tavare (ENG),1980-1984,29,29,7,7,0,0,7,2 (2ct 0st),0.241
954,JWA Taylor (ENG),2011-2015,27,27,7,7,0,0,7,3 (3ct 0st),0.259
955,AC Voges (AUS),2007-2013,31,31,7,7,0,0,7,2 (2ct 0st),0.225
956,DF Watts (SCOT),2006-2011,36,35,7,7,0,0,7,2 (2ct 0st),0.200
957,VJ Wells (ENG),1999-1999,9,9,7,7,0,0,7,3 (3ct 0st),0.777
958,Aftab Alam (AFG),2010-2019,27,27,6,6,0,0,6,2 (2ct 0st),0.222
959,Ashfaq Ahmed (UAE),2018-2019,16,16,6,6,0,0,6,2 (2ct 0st),0.375
960,B Bhandari (NEPAL),2019-2019,3,3,6,6,0,6,0,3 (3ct 0st),2.000
961,IDR Bradshaw (WI),2004-2007,62,62,6,6,0,0,6,1 (1ct 0st),0.096
962,JP Bray (IRE),2006-2007,15,15,6,6,0,1,5,2 (2ct 0st),0.400
963,AD Brown (ENG),1996-2001,16,16,6,6,0,0,6,2 (2ct 0st),0.375
964,DG Brownlie (NZ),2012-2017,16,16,6,6,0,0,6,1 (1ct 0st),0.375
965,Mudassar Bukhari (NL),2007-2014,46,46,6,6,0,0,6,1 (1ct 0st),0.130
966,LJ Burger (NAM),2003-2003,6,6,6,6,0,0,6,3 (3ct 0st),1.000
967,DJ Callaghan (SA),1992-2000,29,28,6,6,0,0,6,2 (2ct 0st),0.214
968,DJ Capel (ENG),1987-1990,23,23,6,6,0,0,6,2 (2ct 0st),0.260
969,TL Chatara (ZIM),2013-2019,70,70,6,6,0,0,6,1 (1ct 0st),0.085
970,S Chattergoon (WI),2006-2009,18,17,6,6,0,0,6,2 (2ct 0st),0.352
971,TS Chisoro (ZIM),2015-2018,18,17,6,6,0,0,6,2 (2ct 0st),0.352
972,GR Codrington (CAN),2006-2007,17,17,6,6,0,0,6,1 (1ct 0st),0.352
973,DG Cork (ENG),1992-2002,32,32,6,6,0,0,6,2 (2ct 0st),0.187
974,CD Cumming (NZ),2003-2009,13,13,6,6,0,0,6,2 (2ct 0st),0.461
975,WM Darling (AUS),1978-1982,18,17,6,6,0,0,6,3 (3ct 0st),0.352
976,TN de Grooth (NL),2006-2013,34,34,6,6,0,0,6,1 (1ct 0st),0.176
977,AM de Silva (SL),1986-1993,4,4,6,4,2,4,0,3 (2ct 1st),1.500
978,EAR de Silva (SL),1986-1992,28,28,6,6,0,0,6,2 (2ct 0st),0.214
979,T Duffin (ZIM),2006-2007,23,23,6,6,0,0,6,1 (1ct 0st),0.260
980,PH Edmonds (ENG),1977-1987,29,29,6,6,0,0,6,2 (2ct 0st),0.206
981,Enamul Haque (BDESH),1990-2002,29,29,6,6,0,0,6,3 (3ct 0st),0.206
982,MG Erasmus (NAM),2019-2019,5,5,6,6,0,0,6,2 (2ct 0st),1.200
983,AC Evans (SCOT),2009-2019,34,33,6,6,0,0,6,1 (1ct 0st),0.181
984,N Pradeep (SL),2012-2019,42,41,6,6,0,0,6,2 (2ct 0st),0.146
985,WIA Fernando (SL),2016-2019,15,15,6,6,0,0,6,2 (2ct 0st),0.400
986,G Fowler (ENG),1983-1986,26,26,6,4,2,2,2,3 (1ct 2st),0.230
987,AD Gaekwad (INDIA),1975-1987,15,14,6,6,0,0,6,1 (1ct 0st),0.428
988,MR Gillespie (NZ),2006-2009,32,31,6,6,0,0,6,2 (2ct 0st),0.193
989,Hamza Tariq (CAN),2011-2014,7,7,6,5,1,5,0,2 (2ct 0st),0.857
990,RJ Harris (AUS),2009-2012,21,21,6,6,0,0,6,1 (1ct 0st),0.285
991,Harvinder Singh (INDIA),1997-2001,16,16,6,6,0,0,6,1 (1ct 0st),0.375
992,Hasibul Hossain (BDESH),1995-2004,32,32,6,6,0,0,6,2 (2ct 0st),0.187
993,UC Hathurusingha (SL),1992-1999,35,35,6,6,0,0,6,1 (1ct 0st),0.171
994,VA Holder (WI),1973-1978,12,12,6,6,0,0,6,1 (1ct 0st),0.500
995,BC Hollioake (ENG),1997-2002,20,20,6,6,0,0,6,1 (1ct 0st),0.300
996,MG Hughes (AUS),1988-1993,33,33,6,6,0,0,6,1 (1ct 0st),0.181
997,Imtiaz Abbasi (UAE),1994-1996,7,7,6,4,2,4,0,2 (2ct 0st),0.857
998,RC Irani (ENG),1996-2003,31,31,6,6,0,0,6,1 (1ct 0st),0.193
999,WR James (ZIM),1992-1996,11,11,6,6,0,3,3,2 (2ct 0st),0.545
1000,TP Kamungozi (ZIM),2006-2015,14,14,6,6,0,0,6,2 (2ct 0st),0.428
1001,AY Karim (KENYA),1996-2003,34,34,6,6,0,0,6,1 (1ct 0st),0.176
1002,Karim Sadiq (AFG),2009-2016,24,24,6,6,0,0,6,2 (2ct 0st),0.250
1003,Khurram Khan (UAE),2004-2015,16,16,6,6,0,0,6,2 (2ct 0st),0.375
1004,CL King (WI),1976-1980,18,18,6,6,0,0,6,1 (1ct 0st),0.333
1005,JK Lever (ENG),1976-1982,22,22,6,6,0,0,6,2 (2ct 0st),0.272
1006,DK Liyanage (SL),1992-2001,16,16,6,6,0,0,6,2 (2ct 0st),0.375
1007,NB Mahwire (ZIM),2004-2006,23,23,6,6,0,0,6,2 (2ct 0st),0.260
1008,Manjural Islam Rana (BDESH),2003-2006,25,25,6,6,0,0,6,1 (1ct 0st),0.240
1009,JJ Martin (INDIA),1999-2001,10,10,6,6,0,0,6,3 (3ct 0st),0.600
1010,Mehrab Hossain (BDESH),1998-2003,18,18,6,6,0,0,6,2 (2ct 0st),0.333
1011,Mohammad Mithun (BDESH),2014-2019,24,24,6,6,0,0,6,2 (2ct 0st),0.250
1012,Mohammad Naveed (UAE),2014-2019,39,39,6,6,0,0,6,1 (1ct 0st),0.153
1013,JFM Morrison (NZ),1975-1983,18,18,6,6,0,0,6,2 (2ct 0st),0.333
1014,Mujeeb Ur Rahman (AFG),2017-2019,37,36,6,6,0,0,6,1 (1ct 0st),0.166
1015,Mushfiqur Rahman (BDESH),2000-2004,28,28,6,6,0,0,6,1 (1ct 0st),0.214
1016,MV Nagamootoo (WI),2000-2002,24,24,6,6,0,0,6,1 (1ct 0st),0.250
1017,A Nao (PNG),2017-2019,13,13,6,6,0,0,6,2 (2ct 0st),0.461
1018,Nazmul Hossain (BDESH),2004-2012,38,38,6,6,0,0,6,1 (1ct 0st),0.157
1019,L Ngidi (SA),2018-2019,22,22,6,6,0,0,6,2 (2ct 0st),0.272
1020,JO Ngoche (KENYA),2010-2013,17,17,6,6,0,0,6,1 (1ct 0st),0.352
1021,ML Nkala (ZIM),1998-2006,50,50,6,6,0,0,6,1 (1ct 0st),0.120
1022,AH Omarshah (ZIM),1983-1996,28,28,6,6,0,0,6,2 (2ct 0st),0.214
1023,SD Outerbridge (BMUDA),2006-2009,23,23,6,6,0,0,6,1 (1ct 0st),0.260
1024,MK Pandey (INDIA),2015-2018,23,23,6,6,0,0,6,1 (1ct 0st),0.260
1025,LS Pascoe (AUS),1977-1982,29,29,6,6,0,0,6,1 (1ct 0st),0.206
1026,TRO Payne (WI),1984-1987,7,7,6,6,0,2,4,2 (2ct 0st),0.857
1027,VD Philander (SA),2007-2015,30,28,6,6,0,0,6,2 (2ct 0st),0.214
1028,N Pokana (PNG),2017-2019,14,14,6,6,0,0,6,3 (3ct 0st),0.428
1029,D Pretorius (SA),2016-2019,22,22,6,6,0,0,6,2 (2ct 0st),0.272
1030,AJ Pycroft (ZIM),1983-1992,20,20,6,6,0,0,6,2 (2ct 0st),0.300
1031,CG Rackemann (AUS),1983-1991,52,52,6,6,0,0,6,1 (1ct 0st),0.115
1032,Rameez Shahzad (UAE),2016-2018,15,15,6,6,0,0,6,1 (1ct 0st),0.400
1033,BA Reid (AUS),1986-1992,61,61,6,6,0,0,6,2 (2ct 0st),0.098
1034,AME Roberts (WI),1975-1983,56,56,6,6,0,0,6,1 (1ct 0st),0.107
1035,RT Robinson (ENG),1984-1988,26,26,6,6,0,0,6,2 (2ct 0st),0.230
1036,FA Rose (WI),1997-2000,27,27,6,6,0,0,6,1 (1ct 0st),0.222
1037,Shabir Noori (AFG),2010-2016,10,10,6,6,0,0,6,2 (2ct 0st),0.600
1038,Sharjeel Khan (PAK),2013-2017,25,25,6,6,0,0,6,1 (1ct 0st),0.240
1039,AK Sharma (INDIA),1988-1993,31,31,6,6,0,0,6,2 (2ct 0st),0.193
1040,MM Sharma (INDIA),2013-2015,26,25,6,6,0,0,6,1 (1ct 0st),0.240
1041,RJ Sidebottom (ENG),2001-2010,25,25,6,6,0,0,6,1 (1ct 0st),0.240
1042,EO Simons (SA),1994-1995,23,23,6,6,0,0,6,1 (1ct 0st),0.260
1043,TAM Siriwardana (SL),2015-2019,27,26,6,6,0,0,6,2 (2ct 0st),0.230
1044,ZE Surkari (CAN),2008-2011,23,22,6,6,0,0,6,1 (1ct 0st),0.272
1045,RML Taylor (SCOT),2013-2016,15,15,6,6,0,0,6,2 (2ct 0st),0.400
1046,Tushar Imran (BDESH),2001-2007,41,41,6,6,0,0,6,1 (1ct 0st),0.146
1047,Umar Amin (PAK),2010-2018,16,16,6,6,0,0,6,2 (2ct 0st),0.375
1048,DL Underwood (ENG),1973-1982,26,26,6,6,0,0,6,2 (2ct 0st),0.230
1049,AV Vadher (KENYA),1997-1999,18,18,6,6,0,0,6,2 (2ct 0st),0.333
1050,LP van Troost (NL),2002-2007,23,23,6,6,0,0,6,1 (1ct 0st),0.260
1051,Y Venugopal Rao (INDIA),2005-2006,16,16,6,6,0,0,6,2 (2ct 0st),0.375
1052,R Vinay Kumar (INDIA),2010-2013,31,31,6,6,0,0,6,2 (2ct 0st),0.193
1053,MHN Walker (AUS),1974-1981,17,17,6,6,0,0,6,1 (1ct 0st),0.352
1054,MRJ Watt (SCOT),2016-2019,24,24,6,6,0,0,6,1 (1ct 0st),0.250
1055,AGD Wickremasinghe (SL),1992-1993,4,4,6,2,4,2,0,3 (1ct 2st),1.500
1056,B Wood (ENG),1972-1982,13,13,6,6,0,0,6,2 (2ct 0st),0.461
1057,Yasir Shah (PAK),2011-2019,25,25,6,6,0,0,6,2 (2ct 0st),0.240
1058,Abdul Shakoor (UAE),2015-2018,3,3,5,4,1,2,2,3 (2ct 1st),1.666
1059,FA Allen (WI),2018-2019,12,11,5,5,0,0,5,2 (2ct 0st),0.454
1060,GI Allott (NZ),1997-2000,31,31,5,5,0,0,5,1 (1ct 0st),0.161
1061,Anshuman Rath (HKG),2014-2018,18,18,5,5,0,0,5,1 (1ct 0st),0.277
1062,Arafat Sunny (BDESH),2014-2015,16,16,5,5,0,0,5,1 (1ct 0st),0.312
1063,Arshad Ayub (INDIA),1987-1990,32,32,5,5,0,0,5,1 (1ct 0st),0.156
1064,Asif Ali (PAK),2018-2019,18,17,5,5,0,0,5,1 (1ct 0st),0.294
1065,JT Ball (ENG),2016-2018,18,18,5,5,0,0,5,3 (3ct 0st),0.277
1066,CA Best (WI),1986-1992,24,23,5,5,0,0,5,2 (2ct 0st),0.217
1067,U Bhatti (CAN),2006-2010,36,35,5,5,0,0,5,1 (1ct 0st),0.142
1068,SL Boock (NZ),1978-1987,14,13,5,5,0,0,5,1 (1ct 0st),0.384
1069,G Boycott (ENG),1971-1981,36,35,5,5,0,0,5,3 (3ct 0st),0.142
1070,DH Brain (ZIM),1992-1995,23,23,5,5,0,0,5,2 (2ct 0st),0.217
1071,RD Brown (ZIM),1983-1987,7,7,5,5,0,0,5,2 (2ct 0st),0.714
1072,RJ Campbell (AUS),2002-2002,2,2,5,4,1,4,0,3 (2ct 1st),2.500
1073,IM Chappell (AUS),1971-1980,16,16,5,5,0,0,5,2 (2ct 0st),0.312
1074,PKD Chase (IRE),2015-2018,25,24,5,5,0,0,5,2 (2ct 0st),0.208
1075,RL Chase (WI),2017-2019,19,17,5,5,0,0,5,1 (1ct 0st),0.294
1076,NG Cowans (ENG),1983-1985,23,23,5,5,0,0,5,1 (1ct 0st),0.217
1077,CE Cuffy (WI),1994-2002,41,41,5,5,0,0,5,1 (1ct 0st),0.121
1078,WW Daniel (WI),1978-1984,18,18,5,5,0,0,5,1 (1ct 0st),0.277
1079,SP Davis (AUS),1986-1988,39,39,5,5,0,0,5,1 (1ct 0st),0.128
1080,MH Dekker (ZIM),1992-1996,23,23,5,5,0,0,5,1 (1ct 0st),0.217
1081,JW Dernbach (ENG),2011-2013,24,24,5,5,0,0,5,2 (2ct 0st),0.208
1082,DS de Silva (SL),1975-1985,41,41,5,5,0,0,5,1 (1ct 0st),0.121
1083,PWH de Silva (SL),2017-2019,12,12,5,5,0,0,5,2 (2ct 0st),0.416
1084,K Doriga (PNG),2017-2019,14,14,5,4,1,3,1,1 (1ct 0st),0.357
1085,VC Drakes (WI),1995-2004,34,34,5,5,0,0,5,1 (1ct 0st),0.147
1086,GD Drummond (SCOT),2007-2013,30,29,5,5,0,0,5,1 (1ct 0st),0.172
1087,H Durham (BMUDA),2006-2006,9,9,5,5,0,0,5,2 (2ct 0st),0.555
1088,GN Edwards (NZ),1976-1981,6,6,5,5,0,2,3,2 (2ct 0st),0.833
1089,RMS Eranga (SL),2011-2016,19,18,5,5,0,0,5,2 (2ct 0st),0.277
1090,SM Ervine (ZIM),2001-2004,42,42,5,5,0,0,5,1 (1ct 0st),0.119
1091,Faheem Ashraf (PAK),2017-2019,23,22,5,5,0,0,5,1 (1ct 0st),0.227
1092,SE Findlay (WI),2008-2009,9,9,5,5,0,0,5,2 (2ct 0st),0.555
1093,ARC Fraser (ENG),1989-1999,42,42,5,5,0,0,5,1 (1ct 0st),0.119
1094,RS Gavaskar (INDIA),2004-2004,11,11,5,5,0,0,5,2 (2ct 0st),0.454
1095,AFG Griffith (WI),1996-2000,9,9,5,5,0,0,5,2 (2ct 0st),0.555
1096,Hamid Hassan (AFG),2009-2019,38,37,5,5,0,0,5,1 (1ct 0st),0.135
1097,BR Hartland (NZ),1992-1994,16,16,5,5,0,0,5,1 (1ct 0st),0.312
1098,JW Hastings (AUS),2010-2017,29,29,5,5,0,0,5,2 (2ct 0st),0.172
1099,RC Haynes (WI),1989-1991,8,8,5,5,0,0,5,2 (2ct 0st),0.625
1100,EE Hemmings (ENG),1982-1991,33,33,5,5,0,0,5,1 (1ct 0st),0.151
1101,M Hendrick (ENG),1973-1981,22,22,5,5,0,0,5,1 (1ct 0st),0.227
1102,RS Higgins (ZIM),2006-2006,11,11,5,5,0,0,5,1 (1ct 0st),0.454
1103,PJC Hoffmann (SCOT),2006-2007,18,17,5,5,0,0,5,1 (1ct 0st),0.294
1104,MJ Hoggard (ENG),2001-2006,26,26,5,5,0,0,5,1 (1ct 0st),0.192
1105,PJ Hughes (AUS),2013-2014,25,25,5,5,0,2,3,2 (2ct 0st),0.200
1106,RO Hurley (WI),2003-2004,9,9,5,5,0,0,5,2 (2ct 0st),0.555
1107,Ikram Alikhil (AFG),2019-2019,9,8,5,2,3,2,0,2 (1ct 1st),0.625
1108,Imran Haider (UAE),2017-2019,20,20,5,5,0,0,5,1 (1ct 0st),0.250
1109,WS Jayantha (SL),2004-2004,17,17,5,5,0,0,5,1 (1ct 0st),0.294
1110,HAPW Jayawardene (SL),2003-2007,6,6,5,4,1,4,0,2 (2ct 0st),0.833
1111,TE Jesty (ENG),1983-1983,10,10,5,5,0,0,5,2 (2ct 0st),0.500
1112,VB John (SL),1982-1987,45,45,5,5,0,0,5,1 (1ct 0st),0.111
1113,MO Jones (BMUDA),2006-2007,12,12,5,5,0,0,5,3 (3ct 0st),0.416
1114,AS Joseph (WI),2016-2018,16,15,5,5,0,0,5,1 (1ct 0st),0.333
1115,RJ Kirtley (ENG),2001-2004,11,11,5,5,0,0,5,1 (1ct 0st),0.454
1116,Krishna Chandran (UAE),2014-2016,12,12,5,5,0,0,5,2 (2ct 0st),0.416
1117,BP Kruger (NL),2010-2011,5,5,5,5,0,0,5,3 (3ct 0st),1.000
1118,Kuldeep Yadav (INDIA),2017-2019,53,52,5,5,0,0,5,1 (1ct 0st),0.096
1119,BM Laird (AUS),1979-1982,23,23,5,5,0,0,5,1 (1ct 0st),0.217
1120,D Langford-Smith (IRE),2006-2008,22,21,5,5,0,0,5,2 (2ct 0st),0.238
1121,KS Lokuarachchi (SL),2003-2007,21,21,5,5,0,0,5,1 (1ct 0st),0.238
1122,GI Maiden (SCOT),2010-2011,7,7,5,5,0,5,0,3 (3ct 0st),0.714
1123,JS Malhotra (USA),2019-2019,5,5,5,4,1,4,0,2 (2ct 0st),1.000
1124,GA Manou (AUS),2009-2009,4,4,5,5,0,5,0,3 (3ct 0st),1.250
1125,A Mishra (INDIA),2003-2016,36,35,5,5,0,0,5,1 (1ct 0st),0.142
1126,Mohammad Asif (Asia/PAK),2005-2010,38,36,5,5,0,0,5,2 (2ct 0st),0.138
1127,Mohammad Hussain (PAK),1997-1998,14,13,5,5,0,0,5,2 (2ct 0st),0.384
1128,Mohammad Nawaz (3) (PAK),2016-2019,15,15,5,5,0,0,5,2 (2ct 0st),0.333
1129,Mohammad Tauqir (UAE),2004-2015,11,11,5,5,0,0,5,2 (2ct 0st),0.454
1130,MD Moxon (ENG),1985-1988,8,8,5,5,0,0,5,2 (2ct 0st),0.625
1131,AN Petersen (SA),2006-2013,21,21,5,5,0,0,5,1 (1ct 0st),0.238
1132,N Pothas (SA),2000-2000,3,3,5,4,1,4,0,3 (2ct 1st),1.666
1133,Qaiser Ali (CAN),2006-2008,17,17,5,5,0,0,5,2 (2ct 0st),0.294
1134,JF Reid (NZ),1980-1986,25,23,5,5,0,0,5,1 (1ct 0st),0.217
1135,DM Richards (WI),2009-2010,8,8,5,5,0,0,5,2 (2ct 0st),0.625
1136,Sadiq Mohammad (PAK),1973-1980,19,19,5,5,0,0,5,2 (2ct 0st),0.263
1137,MAR Samarasekera (SL),1983-1994,39,39,5,5,0,0,5,2 (2ct 0st),0.128
1138,BS Sandhu (INDIA),1982-1984,22,21,5,5,0,0,5,1 (1ct 0st),0.238
1139,Shahadat Hossain (BDESH),2006-2013,51,51,5,5,0,0,5,1 (1ct 0st),0.098
1140,Shahriar Hossain (BDESH),1997-2004,20,20,5,5,0,0,5,1 (1ct 0st),0.250
1141,T Shamsi (SA),2016-2019,17,17,5,5,0,0,5,2 (2ct 0st),0.294
1142,Shapoor Zadran (AFG),2009-2019,44,44,5,5,0,0,5,1 (1ct 0st),0.113
1143,JN Snape (ENG),2001-2002,10,10,5,5,0,0,5,2 (2ct 0st),0.500
1144,CA Soper (PNG),2016-2019,20,20,5,5,0,0,5,2 (2ct 0st),0.250
1145,ELR Stewart (SA),1993-2002,6,6,5,5,0,5,0,2 (2ct 0st),0.833
1146,MR Swart (NL),2011-2014,12,12,5,5,0,0,5,2 (2ct 0st),0.416
1147,Wajahatullah Wasti (PAK),1999-2000,15,15,5,5,0,0,5,1 (1ct 0st),0.333
1148,BGK Walker (NZ),2000-2002,11,11,5,5,0,0,5,1 (1ct 0st),0.454
1149,B Warnapura (SL),1975-1982,12,12,5,5,0,0,5,2 (2ct 0st),0.416
1150,SR Waters (KENYA),2008-2011,20,20,5,5,0,0,5,2 (2ct 0st),0.250
1151,GH Worker (NZ),2015-2018,10,10,5,5,0,0,5,3 (3ct 0st),0.500
1152,GN Yallop (AUS),1978-1984,30,27,5,5,0,0,5,2 (2ct 0st),0.185
1153,Ziaur Rahman (BDESH),2013-2014,13,13,5,5,0,0,5,1 (1ct 0st),0.384
1154,Adnan Mufti (UAE),2017-2018,18,18,4,4,0,0,4,1 (1ct 0st),0.222
1155,AC Agar (AUS),2015-2018,9,9,4,4,0,0,4,1 (1ct 0st),0.444
1156,Ahsan Malik (NL),2011-2014,12,12,4,4,0,0,4,2 (2ct 0st),0.333
1157,Amir Hayat (UAE),2018-2019,9,9,4,4,0,0,4,1 (1ct 0st),0.444
1158,Anwar Ali (PAK),2013-2016,22,22,4,4,0,0,4,2 (2ct 0st),0.181
1159,JC Archer (ENG),2019-2019,14,14,4,4,0,0,4,1 (1ct 0st),0.285
1160,J Arun Lal (INDIA),1982-1989,13,13,4,4,0,0,4,1 (1ct 0st),0.307
1161,Atiq-uz-Zaman (PAK),2000-2000,3,3,4,3,1,3,0,3 (3ct 0st),1.333
1162,AM Bacher (SA),1997-2005,13,13,4,4,0,0,4,2 (2ct 0st),0.307
1163,SB Bangar (INDIA),2002-2004,15,15,4,4,0,0,4,2 (2ct 0st),0.266
1164,GD Barlow (ENG),1976-1977,6,6,4,4,0,0,4,2 (2ct 0st),0.666
1165,GJ Batty (ENG),2002-2009,10,10,4,4,0,0,4,2 (2ct 0st),0.400
1166,AC Bedade (INDIA),1994-1994,13,12,4,4,0,0,4,1 (1ct 0st),0.333
1167,BS Bedi (INDIA),1974-1979,10,10,4,4,0,0,4,3 (3ct 0st),0.400
1168,KCG Benjamin (WI),1992-1996,26,26,4,4,0,0,4,2 (2ct 0st),0.153
1169,TL Best (WI),2004-2014,26,26,4,4,0,0,4,1 (1ct 0st),0.153
1170,BR Blair (NZ),1982-1986,14,13,4,4,0,0,4,2 (2ct 0st),0.307
1171,DR Brown (ENG/SCOT),1997-2007,25,25,4,4,0,0,4,1 (1ct 0st),0.160
1172,HR Bryan (WI),1999-1999,15,15,4,4,0,0,4,1 (1ct 0st),0.266
1173,IP Butchart (ZIM),1983-1995,20,20,4,4,0,0,4,1 (1ct 0st),0.200
1174,GD Campbell (AUS),1989-1990,12,12,4,4,0,0,4,1 (1ct 0st),0.333
1175,KED Carroll (IRE),2007-2007,6,6,4,4,0,0,4,2 (2ct 0st),0.666
1176,PVD Chameera (SL),2015-2019,23,23,4,4,0,0,4,1 (1ct 0st),0.173
1177,BB Chari (ZIM),2015-2019,11,10,4,3,1,1,2,2 (1ct 1st),0.400
1178,DN Chudasama (KENYA),1996-1999,20,20,4,4,0,0,4,1 (1ct 0st),0.200
1179,ST Clarke (WI),1978-1982,10,10,4,4,0,0,4,1 (1ct 0st),0.400
1180,GJ Cosier (AUS),1975-1979,9,8,4,4,0,0,4,2 (2ct 0st),0.500
1181,TK Curran (ENG),2017-2019,17,17,4,4,0,0,4,1 (1ct 0st),0.235
1182,PC de Silva (SL),2014-2017,7,7,4,4,0,0,4,2 (2ct 0st),0.571
1183,GR Dilley (ENG),1979-1988,36,36,4,4,0,0,4,2 (2ct 0st),0.111
1184,FH Edwards (WI),2003-2009,50,49,4,4,0,0,4,1 (1ct 0st),0.081
1185,SA Edwards (NL),2018-2019,4,4,4,4,0,4,0,3 (3ct 0st),1.000
1186,D Elgar (SA),2012-2018,8,8,4,4,0,0,4,2 (2ct 0st),0.500
1187,FM Engineer (INDIA),1974-1975,5,5,4,3,1,3,0,1 (1ct 0st),0.800
1188,KWR Fletcher (ENG),1971-1982,24,23,4,4,0,0,4,1 (1ct 0st),0.173
1189,DR Flynn (NZ),2008-2012,20,20,4,4,0,0,4,1 (1ct 0st),0.200
1190,PJ Forrest (AUS),2012-2012,15,15,4,4,0,0,4,1 (1ct 0st),0.266
1191,RC Fredericks (WI),1973-1977,12,12,4,4,0,0,4,1 (1ct 0st),0.333
1192,HJW Gardiner (SCOT),2013-2015,11,11,4,4,0,0,4,2 (2ct 0st),0.363
1193,HM Goonatilleke (SL),1982-1982,6,6,4,0,4,0,0,2 (0ct 2st),0.666
1194,TR Gripper (ZIM),2001-2003,8,8,4,4,0,0,4,2 (2ct 0st),0.500
1195,Hammad Azam (PAK),2011-2015,11,11,4,4,0,0,4,2 (2ct 0st),0.363
1196,Haseeb Amjad (HKG),2014-2016,7,7,4,4,0,0,4,1 (1ct 0st),0.571
1197,BF Hastings (NZ),1973-1975,11,11,4,4,0,0,4,2 (2ct 0st),0.363
1198,M Hayward (SA),1998-2002,21,21,4,4,0,0,4,1 (1ct 0st),0.190
1199,MC Henriques (AUS),2009-2017,11,11,4,4,0,0,4,2 (2ct 0st),0.363
1200,PA Hitchcock (NZ),2002-2008,14,13,4,4,0,0,4,1 (1ct 0st),0.307
1201,RD Jackman (ENG),1974-1983,15,15,4,4,0,0,4,1 (1ct 0st),0.266
1202,SC Joseph (WI),2000-2005,13,13,4,4,0,0,4,1 (1ct 0st),0.307
1203,BD Julien (WI),1973-1977,12,12,4,4,0,0,4,1 (1ct 0st),0.333
1204,S Jyoti (CAN),2006-2010,14,13,4,4,0,0,4,1 (1ct 0st),0.307
1205,RB Kanhai (WI),1973-1975,7,7,4,4,0,0,4,1 (1ct 0st),0.571
1206,MF Kent (AUS),1981-1981,5,5,4,4,0,0,4,2 (2ct 0st),0.800
1207,RD King (WI),1998-2005,50,50,4,4,0,0,4,1 (1ct 0st),0.080
1208,RK Kleinveldt (SA),2013-2013,10,10,4,4,0,0,4,2 (2ct 0st),0.400
1209,A Kuruvilla (INDIA),1997-1997,25,25,4,4,0,0,4,1 (1ct 0st),0.160
1210,RP Lefebvre (NL),1996-2003,11,11,4,4,0,0,4,1 (1ct 0st),0.363
1211,RT Lyons (SCOT),2006-2010,25,25,4,4,0,0,4,1 (1ct 0st),0.160
1212,WK McCallan (IRE),2006-2009,39,37,4,4,0,0,4,1 (1ct 0st),0.108
1213,MJ McClenaghan (NZ),2013-2016,48,46,4,4,0,0,4,1 (1ct 0st),0.086
1214,A McGrath (ENG),2003-2004,14,13,4,4,0,0,4,2 (2ct 0st),0.307
1215,MW Machan (SCOT),2013-2016,23,22,4,4,0,0,4,1 (1ct 0st),0.181
1216,AO Malhotra (INDIA),1982-1986,20,20,4,4,0,0,4,1 (1ct 0st),0.200
1217,AA Mallett (AUS),1971-1975,9,9,4,4,0,0,4,1 (1ct 0st),0.444
1218,WP Masakadza (ZIM),2015-2018,17,17,4,4,0,0,4,2 (2ct 0st),0.235
1219,AD Mascarenhas (ENG),2007-2009,20,20,4,4,0,0,4,2 (2ct 0st),0.200
1220,MJ Mason (NZ),2003-2010,26,25,4,4,0,0,4,1 (1ct 0st),0.160
1221,MP Maynard (ENG),1994-2000,14,13,4,4,0,0,4,1 (1ct 0st),0.307
1222,G Miller (ENG),1977-1984,25,25,4,4,0,0,4,2 (2ct 0st),0.160
1223,Mohsin Kamal (PAK),1984-1989,19,19,4,4,0,0,4,1 (1ct 0st),0.210
1224,Mominul Haque (BDESH),2012-2018,28,28,4,4,0,0,4,1 (1ct 0st),0.142
1225,PWA Mulder (SA),2017-2019,10,10,4,4,0,0,4,2 (2ct 0st),0.400
1226,CT Mutombodzi (ZIM),2013-2015,11,11,4,4,0,0,4,2 (2ct 0st),0.363
1227,Nasir Jamal (AFG),2014-2018,16,15,4,4,0,0,4,2 (2ct 0st),0.266
1228,EO Odumbe (KENYA),1996-1996,8,8,4,4,0,0,4,1 (1ct 0st),0.500
1229,GAHM Parkar (INDIA),1982-1984,10,8,4,4,0,0,4,2 (2ct 0st),0.500
1230,SS Pathirana (SL),2015-2017,18,18,4,4,0,0,4,2 (2ct 0st),0.222
1231,ASA Perera (SL),1998-2001,20,20,4,4,0,0,4,2 (2ct 0st),0.200
1232,NO Perry (WI),1999-2000,21,21,4,4,0,0,4,3 (3ct 0st),0.190
1233,MJ Petrie (SCOT),2009-2009,4,4,4,3,1,3,0,2 (2ct 0st),1.000
1234,AM Phangiso (SA),2013-2016,21,21,4,4,0,0,4,1 (1ct 0st),0.190
1235,IL Philip (SCOT),1999-1999,3,3,4,4,0,0,4,3 (3ct 0st),1.333
1236,Qasim Umar (PAK),1983-1987,31,30,4,4,0,0,4,1 (1ct 0st),0.133
1237,V Rathour (INDIA),1996-1997,7,7,4,4,0,0,4,2 (2ct 0st),0.571
1238,PWE Rawson (ZIM),1983-1987,10,10,4,4,0,0,4,2 (2ct 0st),0.400
1239,Raza-ur-Rehman (CAN),2013-2014,6,6,4,4,0,0,4,4 (4ct 0st),0.666
1240,V Razdan (INDIA),1989-1990,3,3,4,4,0,0,4,2 (2ct 0st),1.333
1241,JA Richardson (AUS),2018-2019,12,12,4,4,0,0,4,1 (1ct 0st),0.333
1242,MJG Rippon (NL),2013-2018,6,6,4,4,0,0,4,1 (1ct 0st),0.666
1243,RD Robinson (AUS),1977-1977,2,2,4,3,1,3,0,4 (3ct 1st),2.000
1244,Sandeep Goud (OMAN),2019-2019,5,5,4,4,0,0,4,2 (2ct 0st),0.800
1245,RL Sanghvi (INDIA),1998-1998,10,10,4,4,0,0,4,2 (2ct 0st),0.400
1246,Shahid Nazir (PAK),1996-2000,17,17,4,4,0,0,4,1 (1ct 0st),0.235
1247,A Shahzad (ENG),2010-2011,11,11,4,4,0,0,4,2 (2ct 0st),0.363
1248,Sikander Bakht (PAK),1977-1989,27,27,4,4,0,0,4,1 (1ct 0st),0.148
1249,RB Simpson (AUS),1978-1978,2,2,4,4,0,0,4,2 (2ct 0st),2.000
1250,JJ Smit (NAM),2019-2019,5,5,4,4,0,0,4,2 (2ct 0st),0.800
1251,GM Strydom (ZIM),2006-2006,12,12,4,4,0,0,4,2 (2ct 0st),0.333
1252,Tareq Aziz (BDESH),2002-2004,10,10,4,4,0,0,4,1 (1ct 0st),0.400
1253,R Telemachus (SA),1998-2006,37,37,4,4,0,0,4,1 (1ct 0st),0.108
1254,J Theron (SA/USA),2010-2019,5,5,4,4,0,0,4,2 (2ct 0st),0.800
1255,S Thuraisingam (CAN),2003-2008,10,10,4,4,0,0,4,2 (2ct 0st),0.400
1256,T Thushara (SL),2008-2010,38,38,4,4,0,0,4,1 (1ct 0st),0.105
1257,DT Tiripano (ZIM),2014-2019,31,30,4,4,0,0,4,1 (1ct 0st),0.133
1258,MK Tiwary (INDIA),2008-2015,12,11,4,4,0,0,4,3 (3ct 0st),0.363
1259,G Toka (PNG),2019-2019,7,7,4,4,0,0,4,2 (2ct 0st),0.571
1260,CT Tremlett (ENG),2005-2011,15,15,4,4,0,0,4,1 (1ct 0st),0.266
1261,RJ Trott (BMUDA),2007-2009,11,11,4,4,0,0,4,1 (1ct 0st),0.363
1262,PCR Tufnell (ENG),1990-1997,20,20,4,4,0,0,4,2 (2ct 0st),0.200
1263,I Udana (SL),2012-2019,15,15,4,4,0,0,4,2 (2ct 0st),0.266
1264,Usman Limbada (CAN),2010-2014,11,11,4,4,0,0,4,2 (2ct 0st),0.363
1265,RH Vance (NZ),1988-1989,8,8,4,4,0,0,4,2 (2ct 0st),0.500
1266,RE van der Merwe (NL/SA),2009-2019,15,15,4,4,0,0,4,1 (1ct 0st),0.266
1267,M van Jaarsveld (SA),2002-2004,11,11,4,4,0,0,4,1 (1ct 0st),0.363
1268,M van Schoor (NAM),2003-2003,5,5,4,4,0,4,0,2 (2ct 0st),0.800
1269,JTC Vaughan (NZ),1992-1996,18,18,4,4,0,0,4,1 (1ct 0st),0.222
1270,S Venkataraghavan (INDIA),1974-1983,15,15,4,4,0,0,4,1 (1ct 0st),0.266
1271,R Vijay Bharadwaj (INDIA),1999-2002,10,10,4,4,0,0,4,1 (1ct 0st),0.400
1272,JM Vince (ENG),2015-2019,13,13,4,4,0,0,4,2 (2ct 0st),0.307
1273,BV Vitori (ZIM),2011-2018,24,24,4,4,0,0,4,1 (1ct 0st),0.166
1274,RM West (IRE),2008-2009,10,9,4,4,0,0,4,1 (1ct 0st),0.444
1275,P Willey (ENG),1977-1986,26,26,4,4,0,0,4,1 (1ct 0st),0.153
1276,BA Williams (AUS),2002-2004,25,24,4,4,0,0,4,2 (2ct 0st),0.166
1277,JW Wilson (NZ),1993-2005,6,6,4,4,0,0,4,2 (2ct 0st),0.666
1278,Zeeshan Maqsood (OMAN),2019-2019,5,5,4,4,0,0,4,2 (2ct 0st),0.800
1279,Aarif Sheikh (NEPAL),2018-2019,6,6,3,3,0,0,3,2 (2ct 0st),0.500
1280,Abid Ali (PAK),2019-2019,4,4,3,3,0,0,3,2 (2ct 0st),0.750
1281,CJ Adams (ENG),1998-2000,5,5,3,3,0,0,3,1 (1ct 0st),0.600
1282,Adeel Raja (NL),2002-2011,21,21,3,3,0,0,3,1 (1ct 0st),0.142
1283,Adnan Akmal (PAK),2011-2012,5,5,3,3,0,3,0,1 (1ct 0st),0.600
1284,RG Aga (KENYA),2004-2014,12,12,3,3,0,0,3,1 (1ct 0st),0.250
1285,DS Airee (NEPAL),2018-2019,6,6,3,3,0,0,3,1 (1ct 0st),0.500
1286,Aizaz Khan (HKG),2014-2018,19,19,3,3,0,0,3,1 (1ct 0st),0.157
1287,MW Alleyne (ENG),1999-2000,10,10,3,3,0,0,3,1 (1ct 0st),0.300
1288,TR Ambrose (ENG),2008-2008,5,5,3,3,0,3,0,1 (1ct 0st),0.600
1289,J Anderson (IRE),2014-2016,8,8,3,3,0,0,3,2 (2ct 0st),0.375
1290,Aqib Ilyas (OMAN),2019-2019,5,5,3,3,0,0,3,2 (2ct 0st),0.600
1291,KJ Arnott (ZIM),1987-1993,13,13,3,3,0,0,3,1 (1ct 0st),0.230
1292,Azeem Hafeez (PAK),1983-1985,15,15,3,3,0,0,3,2 (2ct 0st),0.200
1293,SV Bahutule (INDIA),1997-2003,8,8,3,3,0,0,3,2 (2ct 0st),0.375
1294,WD Balaji Rao (CAN),2008-2011,10,10,3,3,0,0,3,1 (1ct 0st),0.300
1295,ST Banerjee (INDIA),1991-1992,6,6,3,3,0,0,3,1 (1ct 0st),0.500
1296,AB Barath (WI),2010-2012,14,13,3,3,0,0,3,1 (1ct 0st),0.230
1297,OO Bascome (BMUDA),2008-2008,6,6,3,3,0,0,3,1 (1ct 0st),0.500
1298,JP Behrendorff (AUS),2019-2019,11,11,3,3,0,0,3,1 (1ct 0st),0.272
1299,DM Benkenstein (SA),1998-2002,23,23,3,3,0,0,3,1 (1ct 0st),0.130
1300,HK Bennett (NZ),2010-2017,16,16,3,3,0,0,3,1 (1ct 0st),0.187
1301,STR Binny (INDIA),2014-2015,14,12,3,3,0,0,3,2 (2ct 0st),0.250
1302,RJ Blakey (ENG),1992-1993,3,3,3,2,1,2,0,2 (1ct 1st),1.000
1303,SM Boland (AUS),2016-2016,14,14,3,3,0,0,3,1 (1ct 0st),0.214
1304,LE Bosman (Afr/SA),2006-2010,14,14,3,3,0,0,3,2 (2ct 0st),0.214
1305,DAJ Bracewell (NZ),2011-2019,19,19,3,3,0,0,3,1 (1ct 0st),0.157
1306,KC Brathwaite (WI),2016-2017,10,10,3,3,0,0,3,1 (1ct 0st),0.300
1307,CPS Chauhan (INDIA),1978-1981,7,7,3,3,0,0,3,1 (1ct 0st),0.428
1308,Chirag Suri (UAE),2018-2019,11,11,3,3,0,0,3,1 (1ct 0st),0.272
1309,NE Clarke (NL),1996-1996,5,5,3,3,0,0,3,1 (1ct 0st),0.600
1310,D Dasgupta (INDIA),2001-2001,5,5,3,2,1,2,0,1 (1ct 0st),0.600
1311,AG Davies (SCOT),1999-1999,5,5,3,2,1,2,0,2 (1ct 1st),0.600
1312,AP Devcich (NZ),2013-2016,12,12,3,3,0,0,3,1 (1ct 0st),0.250
1313,LHD Dilhara (SL),2005-2013,9,9,3,3,0,0,3,1 (1ct 0st),0.333
1314,DR Doshi (INDIA),1980-1982,15,15,3,3,0,0,3,1 (1ct 0st),0.200
1315,Ehsan Khan (HKG),2016-2018,15,15,3,3,0,0,3,2 (2ct 0st),0.200
1316,CE Eksteen (SA),1991-1994,6,6,3,3,0,0,3,1 (1ct 0st),0.500
1317,AM Ellis (NZ),2012-2013,15,15,3,3,0,0,3,2 (2ct 0st),0.200
1318,PA Emery (AUS),1994-1994,1,1,3,3,0,3,0,3 (3ct 0st),3.000
1319,JJ Esmeijer (NL),2002-2003,6,6,3,3,0,0,3,2 (2ct 0st),0.500
1320,GM Ewing (ZIM),2004-2005,7,7,3,3,0,0,3,2 (2ct 0st),0.428
1321,Faisal Hossain (BDESH),2004-2010,6,6,3,3,0,0,3,1 (1ct 0st),0.500
1322,Faisal Iqbal (PAK),2000-2006,18,18,3,3,0,0,3,1 (1ct 0st),0.166
1323,TCB Fernando (SL),2001-2003,17,17,3,3,0,0,3,2 (2ct 0st),0.176
1324,BT Foakes (ENG),2019-2019,1,1,3,2,1,2,0,3 (2ct 1st),3.000
1325,CR Foggo (BMUDA),2008-2008,4,4,3,3,0,0,3,2 (2ct 0st),0.750
1326,OD Gibson (WI),1995-1997,15,15,3,3,0,0,3,1 (1ct 0st),0.200
1327,DR Gilbert (AUS),1986-1986,14,14,3,3,0,0,3,1 (1ct 0st),0.214
1328,AH Gray (WI),1985-1991,25,25,3,3,0,0,3,1 (1ct 0st),0.120
1329,EJ Gray (NZ),1984-1988,10,10,3,3,0,0,3,2 (2ct 0st),0.300
1330,PW Gunaratne (SL),2002-2003,23,23,3,3,0,0,3,1 (1ct 0st),0.130
1331,Haroon Rasheed (PAK),1977-1982,12,12,3,3,0,0,3,1 (1ct 0st),0.250
1332,Hazratullah Zazai (AFG),2018-2019,13,12,3,3,0,0,3,1 (1ct 0st),0.250
1333,DW Headley (ENG),1996-1999,13,13,3,3,0,0,3,1 (1ct 0st),0.230
1334,SP Heaney (CAN),2006-2006,4,4,3,3,0,0,3,2 (2ct 0st),0.750
1335,HJ Howarth (NZ),1973-1975,9,9,3,3,0,0,3,1 (1ct 0st),0.333
1336,Iftikhar Ahmed (PAK),2015-2019,4,4,3,3,0,0,3,1 (1ct 0st),0.750
1337,PJ Ingram (NZ),2010-2010,8,8,3,3,0,0,3,1 (1ct 0st),0.375
1338,Iqbal Qasim (PAK),1977-1988,15,15,3,3,0,0,3,1 (1ct 0st),0.200
1339,SS Iyer (INDIA),2017-2019,9,9,3,3,0,0,3,2 (2ct 0st),0.333
1340,SD Jack (SA),1994-1995,2,2,3,3,0,0,3,2 (2ct 0st),1.500
1341,PA Jaques (AUS),2006-2007,6,6,3,3,0,0,3,1 (1ct 0st),0.500
1342,Joginder Sharma (INDIA),2004-2007,4,4,3,3,0,0,3,1 (1ct 0st),0.750
1343,Junaid Siddiqui (CAN),2011-2014,9,9,3,3,0,0,3,1 (1ct 0st),0.333
1344,SKW Kelly (BMUDA),2006-2009,10,10,3,3,0,0,3,1 (1ct 0st),0.300
1345,D Keulder (NAM),2003-2003,6,6,3,3,0,0,3,2 (2ct 0st),0.500
1346,P Khadka (NEPAL),2018-2019,6,6,3,3,0,0,3,2 (2ct 0st),0.500
1347,AR Khurasiya (INDIA),1999-2001,12,12,3,3,0,0,3,1 (1ct 0st),0.250
1348,Khurram Chohan (CAN),2009-2014,25,24,3,3,0,0,3,1 (1ct 0st),0.125
1349,Khurram Manzoor (PAK),2008-2009,7,7,3,3,0,0,3,1 (1ct 0st),0.428
1350,LJ Koen (SA),1997-2000,5,5,3,3,0,0,3,2 (2ct 0st),0.600
1351,DB Kotze (NAM),2003-2003,6,6,3,3,0,0,3,1 (1ct 0st),0.500
1352,AP Kuiper (SA),1991-1996,25,25,3,3,0,0,3,1 (1ct 0st),0.120
1353,CBRLS Kumara (SL),2017-2019,13,13,3,3,0,0,3,1 (1ct 0st),0.230
1354,T Kumaran (INDIA),1999-2000,8,8,3,3,0,0,3,1 (1ct 0st),0.375
1355,JL Langer (AUS),1994-1997,8,8,3,2,1,1,1,1 (1ct 0st),0.375
1356,D Lloyd (ENG),1973-1980,8,8,3,3,0,0,3,1 (1ct 0st),0.375
1357,BP Loots (NL),2010-2011,7,7,3,3,0,0,3,2 (2ct 0st),0.428
1358,CA Lynn (AUS),2017-2018,4,4,3,3,0,0,3,2 (2ct 0st),0.750
1359,RB McCosker (AUS),1975-1982,14,14,3,3,0,0,3,1 (1ct 0st),0.214
1360,AJ McKay (NZ),2010-2012,19,19,3,3,0,0,3,1 (1ct 0st),0.157
1361,N Madziva (ZIM),2014-2016,12,12,3,3,0,0,3,1 (1ct 0st),0.250
1362,MAWR Madurasinghe (SL),1988-1992,12,12,3,3,0,0,3,1 (1ct 0st),0.250
1363,Majid Khan (PAK),1973-1982,23,23,3,3,0,0,3,1 (1ct 0st),0.130
1364,A Martin (WI),2011-2011,9,9,3,3,0,0,3,1 (1ct 0st),0.333
1365,TBA May (AUS),1987-1995,47,47,3,3,0,0,3,2 (2ct 0st),0.063
1366,M Mbangwa (ZIM),1996-2002,29,29,3,3,0,0,3,1 (1ct 0st),0.103
1367,JN Mohammed (WI),2011-2018,28,27,3,3,0,0,3,1 (1ct 0st),0.111
1368,R Murray (ZIM),2018-2018,5,5,3,3,0,3,0,1 (1ct 0st),0.600
1369,Mushtaq Mohammad (PAK),1973-1978,10,10,3,3,0,0,3,1 (1ct 0st),0.300
1370,JD Nel (SCOT),2006-2010,19,19,3,3,0,0,3,1 (1ct 0st),0.157
1371,SN Netravalkar (USA),2019-2019,5,5,3,3,0,0,3,3 (3ct 0st),0.600
1372,RAP Nissanka (SL),2001-2003,23,23,3,3,0,0,3,1 (1ct 0st),0.130
1373,Nurul Hasan (BDESH),2016-2016,2,2,3,2,1,2,0,3 (2ct 1st),1.500
1374,LN Onyango (KENYA),1996-2014,29,29,3,3,0,0,3,1 (1ct 0st),0.103
1375,ARM Opatha (SL),1975-1979,5,5,3,3,0,0,3,2 (2ct 0st),0.600
1376,MS Panesar (ENG),2007-2007,26,26,3,3,0,0,3,1 (1ct 0st),0.115
1377,MA Parker (SCOT),2010-2010,10,10,3,3,0,0,3,1 (1ct 0st),0.300
1378,JL Pattinson (AUS),2011-2015,15,15,3,3,0,0,3,1 (1ct 0st),0.200
1379,N Pooran (WI),2019-2019,13,12,3,3,0,0,3,1 (1ct 0st),0.250
1380,RR Powar (INDIA),2004-2007,31,30,3,3,0,0,3,1 (1ct 0st),0.100
1381,MR Pydanna (WI),1980-1983,3,3,3,2,1,2,0,1 (1ct 0st),1.000
1382,S Ramesh (INDIA),1999-1999,24,23,3,3,0,0,3,1 (1ct 0st),0.130
1383,SHA Rance (NZ),2017-2017,2,2,3,3,0,0,3,3 (3ct 0st),1.500
1384,Rashid Khan (PAK),1980-1985,29,28,3,3,0,0,3,1 (1ct 0st),0.107
1385,AJ Redmond (NZ),2009-2010,6,6,3,3,0,0,3,1 (1ct 0st),0.500
1386,RB Reid (NZ),1988-1991,9,9,3,3,0,0,3,1 (1ct 0st),0.333
1387,FL Reifer (WI),1997-2009,8,8,3,3,0,0,3,1 (1ct 0st),0.375
1388,GR Robertson (AUS),1994-1998,13,13,3,3,0,0,3,1 (1ct 0st),0.230
1389,DB Rundle (SA),1994-1994,2,2,3,3,0,0,3,2 (2ct 0st),1.500
1390,Saleem Jaffar (PAK),1986-1990,39,39,3,3,0,0,3,1 (1ct 0st),0.076
1391,DP Samaraweera (SL),1993-1994,5,5,3,3,0,0,3,2 (2ct 0st),0.600
1392,MMC Schewe (NL),1996-1996,5,5,3,2,1,2,0,3 (2ct 1st),0.600
1393,E Schiferli (NL),2002-2013,30,30,3,3,0,0,3,1 (1ct 0st),0.100
1394,Shamsur Rahman (BDESH),2013-2014,10,10,3,3,0,0,3,2 (2ct 0st),0.300
1395,MD Shanaka (SL),2016-2019,22,22,3,3,0,0,3,1 (1ct 0st),0.136
1396,KV Sharma (INDIA),2014-2014,2,2,3,3,0,0,3,2 (2ct 0st),1.500
1397,VRV Singh (INDIA),2006-2006,2,2,3,3,0,0,3,2 (2ct 0st),1.500
1398,TT Smart (HKG),2004-2004,2,2,3,3,0,2,1,2 (2ct 0st),1.500
1399,CJ Smith (BMUDA),2006-2007,12,12,3,3,0,0,3,2 (2ct 0st),0.250
1400,S Snater (NL),2018-2018,2,2,3,3,0,0,3,2 (2ct 0st),1.500
1401,Sohail Khan (PAK),2008-2016,13,13,3,3,0,0,3,1 (1ct 0st),0.230
1402,CB Sole (SCOT),2016-2018,11,11,3,3,0,0,3,2 (2ct 0st),0.272
1403,MC Sorensen (IRE),2013-2016,13,12,3,3,0,0,3,1 (1ct 0st),0.250
1404,DA Stirling (NZ),1984-1984,6,6,3,3,0,0,3,1 (1ct 0st),0.500
1405,PC Strydom (SA),2000-2000,10,10,3,3,0,0,3,2 (2ct 0st),0.300
1406,R Strydom (IRE),2008-2008,9,8,3,3,0,0,3,1 (1ct 0st),0.375
1407,Suraj Kumar (OMAN),2019-2019,5,5,3,3,0,3,0,2 (2ct 0st),0.600
1408,Tanveer Ahmed (HKG),2016-2018,6,6,3,3,0,0,3,2 (2ct 0st),0.500
1409,Tanwir Afzal (HKG),2014-2018,20,20,3,3,0,0,3,1 (1ct 0st),0.150
1410,APB Tennekoon (SL),1975-1979,4,4,3,3,0,0,3,1 (1ct 0st),0.750
1411,SN Thakur (INDIA),2017-2018,5,5,3,3,0,0,3,1 (1ct 0st),0.600
1412,AJ Traicos (ZIM),1983-1993,27,27,3,3,0,0,3,1 (1ct 0st),0.111
1413,A Turner (AUS),1975-1975,6,6,3,3,0,0,3,2 (2ct 0st),0.500
1414,Usman Ghani (AFG),2014-2017,15,15,3,3,0,0,3,1 (1ct 0st),0.200
1415,Usman Shinwari (PAK),2017-2019,17,17,3,3,0,0,3,2 (2ct 0st),0.176
1416,JJ van der Wath (SA),2006-2007,10,10,3,3,0,0,3,1 (1ct 0st),0.300
1417,GR Viswanath (INDIA),1974-1982,25,25,3,3,0,0,3,1 (1ct 0st),0.120
1418,Waqas Barkat (HKG),2014-2018,10,10,3,3,0,0,3,1 (1ct 0st),0.300
1419,SM Warnapura (SL),2007-2008,3,3,3,3,0,0,3,2 (2ct 0st),1.000
1420,PN Webb (NZ),1983-1984,5,5,3,3,0,3,0,1 (1ct 0st),0.600
1421,K Weeraratne (SL),2000-2008,15,15,3,3,0,0,3,1 (1ct 0st),0.200
1422,DS Wesonga (KENYA),2010-2011,4,4,3,3,0,0,3,2 (2ct 0st),0.750
1423,S Wettimuny (SL),1982-1987,35,35,3,3,0,0,3,1 (1ct 0st),0.085
1424,BTJ Wheal (SCOT),2016-2019,13,13,3,3,0,0,3,1 (1ct 0st),0.230
1425,SG Whittingham (SCOT),2017-2018,4,4,3,3,0,0,3,1 (1ct 0st),0.750
1426,KIW Wijegunawardene (SL),1988-1992,26,26,3,3,0,0,3,1 (1ct 0st),0.115
1427,CG Williams (NAM),2019-2019,5,5,3,3,0,0,3,2 (2ct 0st),0.600
1428,RA Woolmer (ENG),1972-1976,6,6,3,3,0,0,3,1 (1ct 0st),0.500
1429,Jai P Yadav (INDIA),2002-2005,12,12,3,3,0,0,3,2 (2ct 0st),0.250
1430,Zahoor Khan (UAE),2017-2019,15,15,3,3,0,0,3,1 (1ct 0st),0.200
1431,M Zondeki (Afr/SA),2002-2008,13,13,3,3,0,0,3,1 (1ct 0st),0.230
1432,Aamir Kaleem (OMAN),2019-2019,2,2,2,2,0,0,2,1 (1ct 0st),1.000
1433,Abdur Rauf (PAK),2008-2008,4,4,2,2,0,0,2,1 (1ct 0st),0.500
1434,MR Adair (IRE),2019-2019,9,9,2,2,0,0,2,1 (1ct 0st),0.222
1435,Aizaz Cheema (PAK),2011-2012,14,14,2,2,0,0,2,1 (1ct 0st),0.142
1436,PJW Allott (ENG),1982-1985,13,13,2,2,0,0,2,1 (1ct 0st),0.153
1437,SW Ambris (WI),2017-2019,8,8,2,2,0,0,2,1 (1ct 0st),0.250
1438,DL Amiss (ENG),1972-1977,18,17,2,2,0,0,2,1 (1ct 0st),0.117
1439,JO Angara (KENYA),1997-2003,17,17,2,2,0,0,2,1 (1ct 0st),0.117
1440,SA Ankola (INDIA),1989-1997,20,20,2,2,0,0,2,1 (1ct 0st),0.100
1441,GG Arnold (ENG),1972-1975,14,13,2,2,0,0,2,1 (1ct 0st),0.153
1442,TD Astle (NZ),2017-2019,9,9,2,2,0,0,2,1 (1ct 0st),0.222
1443,Athar Ali Khan (BDESH),1988-1998,19,19,2,2,0,0,2,1 (1ct 0st),0.105
1444,Azam Khan (PAK),1996-1998,6,6,2,2,0,0,2,1 (1ct 0st),0.333
1445,Azhar Hossain (BDESH),1988-1990,7,7,2,2,0,0,2,1 (1ct 0st),0.285
1446,Azhar Saeed (UAE),1994-1996,7,7,2,2,0,0,2,1 (1ct 0st),0.285
1447,S Badrinath (INDIA),2008-2011,7,7,2,2,0,0,2,2 (2ct 0st),0.285
1448,IPP Batuwitarachchi (UAE),2008-2008,2,2,2,2,0,0,2,2 (2ct 0st),1.000
1449,AR Berenger (UAE),2014-2015,10,10,2,2,0,0,2,1 (1ct 0st),0.200
1450,RA Bhatti (CAN),2011-2011,1,1,2,2,0,2,0,2 (2ct 0st),2.000
1451,RL Bhudia (KENYA),2008-2009,5,5,2,2,0,0,2,1 (1ct 0st),0.400
1452,MP Bicknell (ENG),1990-1991,7,7,2,2,0,0,2,1 (1ct 0st),0.285
1453,Bilal Asif (PAK),2015-2015,3,3,2,2,0,0,2,2 (2ct 0st),0.666
1454,Bilawal Bhatti (PAK),2013-2015,10,10,2,2,0,0,2,1 (1ct 0st),0.200
1455,DCC Borden (BMUDA),2006-2008,12,12,2,2,0,0,2,1 (1ct 0st),0.166
1456,GE Bradburn (NZ),1990-2001,11,11,2,2,0,0,2,1 (1ct 0st),0.181
1457,RJ Bright (AUS),1974-1986,11,11,2,2,0,0,2,1 (1ct 0st),0.181
1458,VR Brown (NZ),1988-1988,3,3,2,2,0,0,2,1 (1ct 0st),0.666
1459,PA Browne (WI),2008-2008,5,5,2,2,0,2,0,1 (1ct 0st),0.400
1460,MG Burmester (ZIM),1992-1995,8,8,2,2,0,0,2,1 (1ct 0st),0.250
1461,JA Burns (AUS),2015-2015,6,6,2,2,0,0,2,1 (1ct 0st),0.333
1462,IW Callen (AUS),1978-1982,5,5,2,2,0,0,2,1 (1ct 0st),0.400
1463,J Cameron-Dow (IRE),2019-2019,4,4,2,2,0,0,2,1 (1ct 0st),0.500
1464,MA Carberry (ENG),2013-2014,6,5,2,2,0,0,2,1 (1ct 0st),0.400
1465,JJ Celestine (BMUDA),2007-2008,8,8,2,2,0,0,2,1 (1ct 0st),0.250
1466,DR Chumney (CAN),2003-2007,21,21,2,2,0,0,2,1 (1ct 0st),0.095
1467,PG Coman (NZ),1973-1974,3,3,2,2,0,0,2,1 (1ct 0st),0.666
1468,G Cook (ENG),1981-1983,6,6,2,2,0,0,2,1 (1ct 0st),0.333
1469,NGB Cook (ENG),1984-1989,3,3,2,2,0,0,2,1 (1ct 0st),0.666
1470,BN Cooper (NL),2013-2019,8,8,2,2,0,0,2,1 (1ct 0st),0.250
1471,JP Crawley (ENG),1994-1999,13,13,2,1,1,0,1,1 (1ct 0st),0.153
1472,DJ Cullen (AUS),2006-2006,5,5,2,2,0,0,2,1 (1ct 0st),0.400
1473,D Daesrath (CAN),2012-2013,4,4,2,2,0,0,2,2 (2ct 0st),0.500
1474,Danish Kaneria (PAK),2001-2007,18,18,2,2,0,0,2,1 (1ct 0st),0.111
1475,HT Davis (NZ),1994-1997,11,11,2,2,0,0,2,1 (1ct 0st),0.181
1476,AC Dawson (SA),1998-2004,19,19,2,2,0,0,2,1 (1ct 0st),0.105
1477,RP de Groen (NZ),1993-1994,12,12,2,2,0,0,2,1 (1ct 0st),0.166
1478,PA Desai (CAN),2010-2014,13,13,2,2,0,0,2,1 (1ct 0st),0.153
1479,GRA de Silva (SL),1975-1982,6,6,2,2,0,0,2,1 (1ct 0st),0.333
1480,MW Douglas (NZ),1994-1995,6,6,2,2,0,0,2,1 (1ct 0st),0.333
1481,TM Dowlin (WI),2009-2010,11,11,2,2,0,0,2,1 (1ct 0st),0.181
1482,KG Duers (ZIM),1992-1992,6,6,2,2,0,0,2,1 (1ct 0st),0.333
1483,SF Dukanwala (UAE),1996-1996,5,5,2,2,0,0,2,1 (1ct 0st),0.400
1484,CI Dunusinghe (SL),1995-1995,1,1,2,1,1,1,0,2 (1ct 1st),2.000
1485,NR Dyer (SCOT),1999-1999,5,5,2,2,0,0,2,1 (1ct 0st),0.400
1486,KA Edwards (WI),2011-2014,16,16,2,2,0,0,2,1 (1ct 0st),0.125
1487,Ehsan Nawaz (HKG),2014-2018,12,12,2,2,0,0,2,1 (1ct 0st),0.166
1488,RM Ellison (ENG),1984-1986,14,14,2,2,0,0,2,2 (2ct 0st),0.142
1489,EA Essop-Adam (ZIM),1992-1992,1,1,2,2,0,0,2,2 (2ct 0st),2.000
1490,Fahim Muntasir (BDESH),2001-2002,3,3,2,2,0,0,2,1 (1ct 0st),0.666
1491,Fareed Ahmad (AFG),2014-2017,5,4,2,2,0,0,2,1 (1ct 0st),0.500
1492,Faruk Ahmed (BDESH),1988-1999,7,7,2,2,0,0,2,1 (1ct 0st),0.285
1493,Fayyaz Butt (OMAN),2019-2019,5,5,2,2,0,0,2,1 (1ct 0st),0.400
1494,KHRK Fernando (SL),2002-2006,7,7,2,2,0,0,2,1 (1ct 0st),0.285
1495,AN French (HKG),2004-2004,2,2,2,2,0,0,2,1 (1ct 0st),1.000
1496,JN Frylinck (NAM),2019-2019,5,5,2,2,0,0,2,2 (2ct 0st),0.400
1497,D Gamage (SL),2003-2003,3,3,2,2,0,0,2,1 (1ct 0st),0.666
1498,JC Gamage (SL),1995-1995,4,4,2,2,0,0,2,1 (1ct 0st),0.500
1499,PLS Gamage (SL),2014-2017,9,9,2,2,0,0,2,1 (1ct 0st),0.222
1500,KD Ghavri (INDIA),1975-1981,19,19,2,2,0,0,2,1 (1ct 0st),0.105
1501,GJ Gilmour (AUS),1974-1975,5,5,2,2,0,0,2,1 (1ct 0st),0.400
1502,DM Gondaria (KENYA),2013-2013,2,2,2,2,0,0,2,1 (1ct 0st),1.000
1503,TG Gordon (CAN),2011-2011,5,5,2,2,0,0,2,1 (1ct 0st),0.400
1504,Z Groenewald (NAM),2019-2019,4,4,2,2,0,0,2,1 (1ct 0st),0.500
1505,TGJ Gruijters (NL),2010-2013,5,5,2,2,0,0,2,1 (1ct 0st),0.400
1506,DR Hadlee (NZ),1973-1976,11,11,2,2,0,0,2,1 (1ct 0st),0.181
1507,Hafizur Rahman (BDESH),1986-1986,2,2,2,2,0,2,0,1 (1ct 0st),1.000
1508,PL Harris (SA),2008-2008,3,3,2,2,0,0,2,1 (1ct 0st),0.666
1509,C Hemraj (WI),2018-2018,6,6,2,2,0,0,2,2 (2ct 0st),0.333
1510,RO Hinds (WI),2001-2004,14,14,2,2,0,0,2,1 (1ct 0st),0.142
1511,ND Hirwani (INDIA),1988-1992,18,18,2,2,0,0,2,1 (1ct 0st),0.111
1512,LG Howell (NZ),1998-1998,12,12,2,2,0,0,2,1 (1ct 0st),0.166
1513,GW Humpage (ENG),1981-1981,3,3,2,2,0,2,0,1 (1ct 0st),0.666
1514,N Ifill (CAN),2003-2006,4,4,2,2,0,0,2,1 (1ct 0st),0.500
1515,Ijaz Faqih (PAK),1980-1988,27,27,2,2,0,0,2,1 (1ct 0st),0.074
1516,IT Iqbal (KENYA),1996-1996,3,3,2,2,0,2,0,2 (2ct 0st),0.666
1517,AJ Ireland (ZIM),2005-2007,26,26,2,2,0,0,2,1 (1ct 0st),0.076
1518,Irfan Ahmed (HKG),2008-2014,6,6,2,2,0,0,2,2 (2ct 0st),0.333
1519,Jatinder Singh (OMAN),2019-2019,5,5,2,2,0,0,2,1 (1ct 0st),0.400
1520,LR Johnson (WI),2008-2015,6,6,2,2,0,0,2,1 (1ct 0st),0.333
1521,MA Jones (SCOT),2018-2018,5,5,2,2,0,0,2,1 (1ct 0st),0.400
1522,Kaleemullah (OMAN),2019-2019,3,3,2,2,0,0,2,2 (2ct 0st),0.666
1523,SMS Kaluperuma (SL),1988-1988,2,2,2,2,0,0,2,1 (1ct 0st),1.000
1524,FJ Klaassen (NL),2018-2019,4,4,2,2,0,0,2,2 (2ct 0st),0.500
1525,JJ Krejza (AUS),2011-2011,8,8,2,2,0,0,2,1 (1ct 0st),0.250
1526,P Krishnamurthy (INDIA),1976-1976,1,1,2,1,1,1,0,2 (1ct 1st),2.000
1527,N Kruger (NL),2011-2011,2,2,2,2,0,0,2,2 (2ct 0st),1.000
1528,DS Kulkarni (INDIA),2014-2016,12,12,2,2,0,0,2,1 (1ct 0st),0.166
1529,NM Kulkarni (INDIA),1997-1998,10,10,2,2,0,0,2,1 (1ct 0st),0.200
1530,RR Kulkarni (INDIA),1983-1987,10,10,2,2,0,0,2,1 (1ct 0st),0.200
1531,B Laughlin (AUS),2009-2009,5,5,2,2,0,0,2,1 (1ct 0st),0.400
1532,P Lever (ENG),1971-1975,10,9,2,2,0,0,2,1 (1ct 0st),0.222
1533,GD Lloyd (ENG),1996-1998,6,6,2,2,0,0,2,1 (1ct 0st),0.333
1534,SCG MacGill (AUS),2000-2000,3,3,2,2,0,0,2,1 (1ct 0st),0.666
1535,BJ McKechnie (NZ),1975-1981,14,14,2,2,0,0,2,1 (1ct 0st),0.142
1536,KH MacLeay (AUS),1983-1987,16,16,2,2,0,0,2,1 (1ct 0st),0.125
1537,TN Madondo (ZIM),1998-2001,13,13,2,2,0,0,2,1 (1ct 0st),0.153
1538,JN Maguire (AUS),1983-1984,23,21,2,2,0,0,2,1 (1ct 0st),0.095
1539,G Malla (NEPAL),2018-2019,6,6,2,2,0,0,2,1 (1ct 0st),0.333
1540,I Maraj (CAN),2003-2003,6,6,2,2,0,0,2,1 (1ct 0st),0.333
1541,A Maregwede (ZIM),2003-2005,11,11,2,2,0,0,2,1 (1ct 0st),0.181
1542,EH Mattis (WI),1981-1981,2,2,2,2,0,0,2,1 (1ct 0st),1.000
1543,B Mavuta (ZIM),2018-2019,7,7,2,2,0,0,2,1 (1ct 0st),0.285
1544,TMK Mawoyo (ZIM),2006-2014,7,7,2,2,0,0,2,1 (1ct 0st),0.285
1545,MC Mendis (SL),1995-1995,1,1,2,2,0,0,2,2 (2ct 0st),2.000
1546,Minhajul Abedin (BDESH),1986-1999,27,27,2,2,0,0,2,1 (1ct 0st),0.074
1547,Mohammad Kashif (NL),2006-2010,11,11,2,2,0,0,2,1 (1ct 0st),0.181
1548,Mohammad Khalil (PAK),2005-2005,3,3,2,2,0,0,2,1 (1ct 0st),0.666
1549,Mohammad Saifuddin (BDESH),2017-2019,20,20,2,2,0,0,2,1 (1ct 0st),0.100
1550,Mohammad Shahzad (UAE),2014-2016,6,6,2,2,0,0,2,1 (1ct 0st),0.333
1551,Mohammed Qasim (UAE),2017-2017,5,5,2,2,0,0,2,1 (1ct 0st),0.400
1552,Mohibullah Oryakhel (AFG),2013-2013,2,2,2,2,0,0,2,1 (1ct 0st),1.000
1553,GMC Mol (NL),2007-2008,6,6,2,2,0,0,2,2 (2ct 0st),0.333
1554,HJC Mol (NL),2002-2008,11,11,2,2,0,0,2,1 (1ct 0st),0.181
1555,PJK Mooney (IRE),2006-2007,4,4,2,2,0,0,2,2 (2ct 0st),0.500
1556,JE Morris (ENG),1990-1991,8,8,2,2,0,0,2,1 (1ct 0st),0.250
1557,Morshed Ali Khan (BDESH),1998-1998,3,3,2,2,0,0,2,1 (1ct 0st),0.666
1558,JK Moss (AUS),1979-1979,1,1,2,2,0,0,2,2 (2ct 0st),2.000
1559,EMDY Munaweera (SL),2017-2017,2,2,2,2,0,0,2,1 (1ct 0st),1.000
1560,W Mwayenga (ZIM),2002-2004,3,3,2,2,0,0,2,1 (1ct 0st),0.666
1561,SJ Myburgh (NL),2011-2018,13,13,2,2,0,0,2,1 (1ct 0st),0.153
1562,Nafees Iqbal (BDESH),2003-2005,16,16,2,2,0,0,2,1 (1ct 0st),0.125
1563,PG Nana (EAf),1975-1975,3,3,2,2,0,0,2,1 (1ct 0st),0.666
1564,Nasir Ahmed (BDESH),1988-1990,7,7,2,1,1,1,0,1 (1ct 0st),0.285
1565,Naved Latif (PAK),2001-2003,11,11,2,2,0,0,2,1 (1ct 0st),0.181
1566,Naveen-ul-Haq (AFG),2016-2016,2,2,2,2,0,0,2,1 (1ct 0st),1.000
1567,Najmul Hossain Shanto (BDESH),2018-2018,3,3,2,2,0,0,2,2 (2ct 0st),0.666
1568,Nazmul Islam (BDESH),2018-2018,5,5,2,2,0,0,2,1 (1ct 0st),0.400
1569,TS Nethula (NZ),2012-2012,5,5,2,2,0,0,2,1 (1ct 0st),0.400
1570,A Nortje (SA),2019-2019,4,4,2,2,0,0,2,2 (2ct 0st),0.500
1571,MP O'Dowd (NL),2019-2019,2,2,2,2,0,0,2,1 (1ct 0st),1.000
1572,FN Otieno (KENYA),2010-2010,4,4,2,2,0,0,2,1 (1ct 0st),0.500
1573,C Overton (ENG),2018-2018,1,1,2,2,0,0,2,2 (2ct 0st),2.000
1574,JV Paranjpe (INDIA),1998-1998,4,4,2,2,0,0,2,1 (1ct 0st),0.500
1575,MD Patel (USA),2019-2019,5,5,2,2,0,0,2,1 (1ct 0st),0.400
1576,TK Patel (USA),2019-2019,5,5,2,2,0,0,2,1 (1ct 0st),0.400
1577,D Paterson (SA),2017-2019,4,4,2,2,0,0,2,2 (2ct 0st),0.500
1578,GA Paterson (ZIM),1983-1987,10,10,2,2,0,0,2,1 (1ct 0st),0.200
1579,RK Paudel (NEPAL),2018-2019,4,4,2,2,0,0,2,1 (1ct 0st),0.500
1580,MDK Perera (SL),2007-2018,13,12,2,2,0,0,2,1 (1ct 0st),0.166
1581,PDRL Perera (SL),1999-2007,19,19,2,2,0,0,2,1 (1ct 0st),0.105
1582,Pervez Mir (PAK),1975-1977,3,3,2,2,0,0,2,1 (1ct 0st),0.666
1583,RG Petrie (NZ),1990-1991,12,12,2,2,0,0,2,1 (1ct 0st),0.166
1584,OL Pitcher (BMUDA),2007-2007,5,5,2,2,0,0,2,1 (1ct 0st),0.400
1585,MW Priest (NZ),1990-1998,18,18,2,2,0,0,2,1 (1ct 0st),0.111
1586,MW Pringle (SA),1992-1994,17,17,2,2,0,0,2,1 (1ct 0st),0.117
1587,PM Pushpakumara (SL),2017-2017,2,2,2,2,0,0,2,1 (1ct 0st),1.000
1588,NV Radford (ENG),1988-1988,6,6,2,2,0,0,2,2 (2ct 0st),0.333
1589,Raees Ahmadzai (AFG),2009-2010,5,5,2,2,0,0,2,1 (1ct 0st),0.400
1590,LS Rajput (INDIA),1985-1987,4,4,2,2,0,0,2,1 (1ct 0st),0.500
1591,WV Raman (INDIA),1988-1996,27,27,2,2,0,0,2,1 (1ct 0st),0.074
1592,S Ranatunga (SL),1994-1996,13,13,2,2,0,0,2,1 (1ct 0st),0.153
1593,D Ravu (PNG),2017-2019,8,8,2,2,0,0,2,1 (1ct 0st),0.250
1594,B Reddy (INDIA),1978-1981,3,3,2,2,0,2,0,1 (1ct 0st),0.666
1595,IR Redpath (AUS),1971-1975,5,5,2,2,0,0,2,1 (1ct 0st),0.400
1596,CP Rizwan (UAE),2019-2019,5,5,2,2,0,0,2,1 (1ct 0st),0.400
1597,Rizwan-uz-Zaman (PAK),1981-1987,3,3,2,2,0,0,2,2 (2ct 0st),0.666
1598,GK Robertson (NZ),1981-1989,10,10,2,2,0,0,2,1 (1ct 0st),0.200
1599,GA Rogers (SCOT),2006-2008,13,12,2,2,0,0,2,1 (1ct 0st),0.166
1600,GRJ Roope (ENG),1973-1978,8,7,2,2,0,0,2,1 (1ct 0st),0.285
1601,LG Rowe (WI),1975-1980,11,11,2,2,0,0,2,1 (1ct 0st),0.181
1602,Rumman Raees (PAK),2017-2018,9,9,2,2,0,0,2,1 (1ct 0st),0.222
1603,HD Rutherford (NZ),2013-2013,4,4,2,2,0,0,2,1 (1ct 0st),0.500
1604,Saeed Azad (PAK),1995-1996,4,4,2,2,0,0,2,1 (1ct 0st),0.500
1605,AK Sah (NEPAL),2018-2018,2,2,2,2,0,2,0,2 (2ct 0st),1.000
1606,AM Salvi (INDIA),2003-2003,4,4,2,2,0,0,2,1 (1ct 0st),0.500
1607,Sameer Zia (UAE),2004-2004,1,1,2,2,0,0,2,2 (2ct 0st),2.000
1608,Saqib Ali (UAE),2008-2014,5,5,2,2,0,0,2,1 (1ct 0st),0.400
1609,Saqlain Haider (UAE),2014-2016,5,5,2,1,1,1,0,1 (1ct 0st),0.400
1610,Sarandeep Singh (INDIA),2002-2003,5,5,2,2,0,0,2,1 (1ct 0st),0.400
1611,AF Sattaur (CAN),2003-2003,3,3,2,2,0,0,2,2 (2ct 0st),0.666
1612,S Seeraj (CAN),2006-2006,1,1,2,2,0,2,0,2 (2ct 0st),2.000
1613,KF Semple (WI),1999-1999,7,7,2,2,0,0,2,1 (1ct 0st),0.285
1614,CP Senanayake (SL),1990-1991,7,7,2,2,0,0,2,1 (1ct 0st),0.285
1615,Shaheen Shah Afridi (PAK),2018-2019,19,18,2,2,0,0,2,1 (1ct 0st),0.111
1616,Shahid Saeed (PAK),1989-1993,10,10,2,2,0,0,2,1 (1ct 0st),0.200
1617,Shahid Wasif (HKG),2016-2018,10,10,2,2,0,0,2,1 (1ct 0st),0.200
1618,Sharafuddin Ashraf (AFG),2014-2019,15,15,2,2,0,0,2,1 (1ct 0st),0.133
1619,G Sharma (INDIA),1985-1987,11,11,2,2,0,0,2,1 (1ct 0st),0.181
1620,TG Shaw (SA),1991-1994,9,9,2,2,0,0,2,1 (1ct 0st),0.222
1621,MQ Sheikh (SCOT),2008-2010,7,7,2,2,0,0,2,1 (1ct 0st),0.285
1622,IT Shillingford (WI),1978-1978,2,2,2,2,0,0,2,1 (1ct 0st),1.000
1623,ED Solkar (INDIA),1974-1976,7,7,2,2,0,0,2,1 (1ct 0st),0.285
1624,IM Stanger (SCOT),1999-2006,5,5,2,2,0,0,2,1 (1ct 0st),0.400
1625,GB Stevenson (ENG),1980-1981,4,4,2,2,0,0,2,1 (1ct 0st),0.500
1626,AM Stuart (AUS),1997-1997,3,3,2,2,0,0,2,2 (2ct 0st),0.666
1627,Taslim Arif (PAK),1980-1980,2,2,2,1,1,0,1,1 (1ct 0st),1.000
1628,SR Taylor (USA),2019-2019,5,5,2,2,0,0,2,1 (1ct 0st),0.400
1629,SP Terry (IRE),2016-2016,5,5,2,2,0,0,2,2 (2ct 0st),0.400
1630,LO Tikolo (KENYA),1996-1996,3,3,2,2,0,0,2,1 (1ct 0st),0.666
1631,SS Tiwary (INDIA),2010-2010,3,3,2,2,0,0,2,1 (1ct 0st),0.666
1632,RJW Topley (ENG),2015-2016,10,10,2,2,0,0,2,1 (1ct 0st),0.200
1633,GB Troup (NZ),1976-1985,22,22,2,2,0,0,2,1 (1ct 0st),0.090
1634,TE Tucker (BMUDA),2008-2009,5,5,2,2,0,0,2,1 (1ct 0st),0.400
1635,KEA Upashantha (SL),1995-2001,12,12,2,2,0,0,2,1 (1ct 0st),0.166
1636,PS Vaidya (INDIA),1995-1996,4,4,2,2,0,0,2,1 (1ct 0st),0.500
1637,JDF Vandersay (SL),2015-2019,12,12,2,2,0,0,2,1 (1ct 0st),0.166
1638,RF van Oosterom (NL),1996-2002,3,3,2,2,0,0,2,1 (1ct 0st),0.666
1639,C Viljoen (NAM),2019-2019,2,2,2,2,0,0,2,2 (2ct 0st),1.000
1640,KDK Vithanage (SL),2013-2014,6,6,2,2,0,0,2,1 (1ct 0st),0.333
1641,MDJ Walker (NZ),2003-2003,3,3,2,2,0,0,2,1 (1ct 0st),0.666
1642,KPJ Warnaweera (SL),1990-1993,6,6,2,2,0,0,2,1 (1ct 0st),0.333
1643,AS Wassan (INDIA),1990-1991,9,9,2,2,0,0,2,1 (1ct 0st),0.222
1644,DS Weerakkody (SL),2017-2017,3,3,2,2,0,0,2,1 (1ct 0st),0.666
1645,UWMBCA Welegedara (SL),2009-2010,10,9,2,2,0,0,2,1 (1ct 0st),0.222
1646,JM Wiener (AUS),1979-1980,7,7,2,2,0,0,2,1 (1ct 0st),0.285
1647,RGCE Wijesuriya (SL),1982-1985,8,8,2,2,0,0,2,1 (1ct 0st),0.250
1648,HS Williams (SA),1999-2000,7,7,2,2,0,0,2,2 (2ct 0st),0.285
1649,PJ Wiseman (NZ),1998-2003,15,14,2,2,0,0,2,1 (1ct 0st),0.142
1650,RD Woolley (AUS),1983-1983,4,2,2,1,1,1,0,2 (1ct 1st),1.000
1651,Yamin Ahmadzai (AFG),2015-2016,3,3,2,2,0,0,2,1 (1ct 0st),0.666
1652,Yasir Arafat (PAK),2000-2009,11,11,2,2,0,0,2,1 (1ct 0st),0.181
1653,B Yograj Singh (INDIA),1980-1981,6,6,2,2,0,0,2,1 (1ct 0st),0.333
1654,BE Young (AUS),1998-1999,6,6,2,2,0,0,2,1 (1ct 0st),0.333
1655,CA Young (IRE),2014-2017,13,12,2,2,0,0,2,1 (1ct 0st),0.166
1656,Zahid Fazal (PAK),1990-1994,19,19,2,2,0,0,2,1 (1ct 0st),0.105
1657,Zahoor Elahi (PAK),1996-1997,14,14,2,2,0,0,2,1 (1ct 0st),0.142
1658,Zulqarnain Haider (PAK),2010-2010,4,4,2,1,1,1,0,2 (1ct 1st),0.500
1659,Aamer Hameed (PAK),1977-1978,2,2,1,1,0,0,1,1 (1ct 0st),0.500
1660,VR Aaron (INDIA),2011-2014,9,9,1,1,0,0,1,1 (1ct 0st),0.111
1661,JS Ababu (KENYA),1999-2006,9,9,1,1,0,0,1,1 (1ct 0st),0.111
1662,Abdullah Mazari (AFG),2010-2010,2,2,1,1,0,0,1,1 (1ct 0st),0.500
1663,Abdul Jabbar (CAN),2007-2007,2,2,1,1,0,0,1,1 (1ct 0st),0.500
1664,S Abrahams (SA),2000-2000,1,1,1,1,0,0,1,1 (1ct 0st),1.000
1665,Abul Hasan (BDESH),2012-2018,7,7,1,1,0,0,1,1 (1ct 0st),0.142
1666,Abu Hider (BDESH),2018-2018,2,2,1,1,0,0,1,1 (1ct 0st),0.500
1667,Afzaal Haider (HKG),2004-2008,4,4,1,1,0,0,1,1 (1ct 0st),0.250
1668,JP Agnew (ENG),1985-1985,3,3,1,1,0,0,1,1 (1ct 0st),0.333
1669,KK Ahmed (INDIA),2018-2019,11,11,1,1,0,0,1,1 (1ct 0st),0.090
1670,Aijaz Ali (USA),2004-2004,2,2,1,1,0,0,1,1 (1ct 0st),0.500
1671,Kabir Ali (ENG),2003-2006,14,13,1,1,0,0,1,1 (1ct 0st),0.076
1672,RW Ali (KENYA),1996-1997,9,9,1,1,0,0,1,1 (1ct 0st),0.111
1673,DI Allan (KENYA),2011-2013,5,5,1,1,0,0,1,1 (1ct 0st),0.200
1674,MJD Allingham (SCOT),1999-1999,3,3,1,1,0,0,1,1 (1ct 0st),0.333
1675,Al-Amin Hossain (BDESH),2014-2015,14,14,1,1,0,0,1,1 (1ct 0st),0.071
1676,S Amarnath (INDIA),1978-1978,3,3,1,1,0,0,1,1 (1ct 0st),0.333
1677,MKDI Amerasinghe (SL),2007-2008,8,8,1,1,0,0,1,1 (1ct 0st),0.125
1678,CR Amini (PNG),2014-2014,2,2,1,1,0,0,1,1 (1ct 0st),0.500
1679,RW Anderson (NZ),1976-1978,2,2,1,1,0,0,1,1 (1ct 0st),0.500
1680,Ankur Vasishta (HKG),2014-2014,4,4,1,1,0,0,1,1 (1ct 0st),0.250
1681,Arshad Ali (UAE),2004-2008,4,4,1,1,0,0,1,1 (1ct 0st),0.250
1682,Arshad Laeeq (UAE),1994-1996,6,6,1,1,0,0,1,1 (1ct 0st),0.166
1683,Asif Masood (PAK),1973-1976,7,7,1,1,0,0,1,1 (1ct 0st),0.142
1684,SJ Baard (NAM),2019-2019,5,5,1,1,0,0,1,1 (1ct 0st),0.200
1685,RJ Bailey (ENG),1985-1990,4,4,1,1,0,0,1,1 (1ct 0st),0.250
1686,LS Baker (WI),2008-2009,10,9,1,1,0,0,1,1 (1ct 0st),0.111
1687,TC Bastiampillai (CAN),2007-2014,13,13,1,1,0,0,1,1 (1ct 0st),0.076
1688,MD Bates (NZ),2012-2012,2,2,1,1,0,0,1,1 (1ct 0st),0.500
1689,T Bavuma (SA),2016-2017,2,2,1,1,0,0,1,1 (1ct 0st),0.500
1690,Bazid Khan (PAK),2004-2008,5,5,1,1,0,0,1,1 (1ct 0st),0.200
1691,MD Bell (NZ),1998-2001,7,7,1,1,0,0,1,1 (1ct 0st),0.142
1692,MJ Bennett (AUS),1984-1985,8,8,1,1,0,0,1,1 (1ct 0st),0.125
1693,GA Bishop (AUS),1987-1987,2,2,1,1,0,0,1,1 (1ct 0st),0.500
1694,J Blackwood (WI),2015-2015,2,2,1,1,0,0,1,1 (1ct 0st),0.500
1695,GH Bodi (SA),2007-2007,2,2,1,1,0,0,1,1 (1ct 0st),0.500
1696,JWHD Boteju (SL),1999-1999,2,2,1,1,0,0,1,1 (1ct 0st),0.500
1697,JE Brinkley (SCOT),1999-1999,5,5,1,1,0,0,1,1 (1ct 0st),0.200
1698,RE Bryson (SA),1997-1997,7,7,1,1,0,0,1,1 (1ct 0st),0.142
1699,CE Bulfin (NZ),1999-1999,4,4,1,1,0,0,1,1 (1ct 0st),0.250
1700,SF Burger (NAM),2003-2003,2,2,1,1,0,0,1,1 (1ct 0st),0.500
1701,SJ Cameron (SCOT),2018-2018,2,2,1,1,0,0,1,1 (1ct 0st),0.500
1702,TK Canning (NZ),2003-2005,4,4,1,1,0,0,1,1 (1ct 0st),0.250
1703,HWR Cartwright (AUS),2017-2017,2,2,1,1,0,0,1,1 (1ct 0st),0.500
1704,MS Chapman (HKG/NZ),2015-2018,5,5,1,1,0,0,1,1 (1ct 0st),0.200
1705,U Chatterjee (INDIA),1995-1995,3,3,1,1,0,0,1,1 (1ct 0st),0.333
1706,DB Close (ENG),1972-1972,3,3,1,1,0,0,1,1 (1ct 0st),0.333
1707,RO Collinge (NZ),1973-1978,15,15,1,1,0,0,1,1 (1ct 0st),0.066
1708,PC Connell (IRE),2008-2010,13,12,1,1,0,0,1,1 (1ct 0st),0.083
1709,SJ Cook (SA),1991-1993,4,4,1,1,0,0,1,1 (1ct 0st),0.250
1710,GJ Crocker (ZIM),1992-1993,6,6,1,1,0,0,1,1 (1ct 0st),0.166
1711,CEH Croft (WI),1977-1981,19,19,1,1,0,0,1,1 (1ct 0st),0.052
1712,ML Cummins (WI),2014-2017,11,10,1,1,0,0,1,1 (1ct 0st),0.100
1713,KM Curran (ZIM),1983-1987,11,11,1,1,0,0,1,1 (1ct 0st),0.090
1714,BCJ Cutting (AUS),2013-2014,4,4,1,1,0,0,1,1 (1ct 0st),0.250
1715,CJ Dala (SA),2018-2018,2,2,1,1,0,0,1,1 (1ct 0st),0.500
1716,WW Davis (WI),1983-1988,35,35,1,1,0,0,1,1 (1ct 0st),0.028
1717,BFW de Leede (NL),2018-2019,3,3,1,1,0,0,1,1 (1ct 0st),0.333
1718,MH Denness (ENG),1973-1975,12,12,1,1,0,0,1,1 (1ct 0st),0.083
1719,JH Desai (USA),2004-2004,1,1,1,1,0,0,1,1 (1ct 0st),1.000
1720,DLS de Silva (SL),1979-1979,2,2,1,1,0,0,1,1 (1ct 0st),0.500
1721,R Dhanraj (WI),1994-1995,6,6,1,1,0,0,1,1 (1ct 0st),0.166
1722,BJ Diamanti (NZ),2009-2009,1,1,1,1,0,0,1,1 (1ct 0st),1.000
1723,AB Dinda (INDIA),2010-2013,13,13,1,1,0,0,1,1 (1ct 0st),0.076
1724,MJ Di Venuto (AUS),1997-1997,9,9,1,1,0,0,1,1 (1ct 0st),0.111
1725,BL D'Oliveira (ENG),1971-1972,4,4,1,1,0,0,1,1 (1ct 0st),0.250
1726,CJ Drum (NZ),1999-1999,5,5,1,1,0,0,1,1 (1ct 0st),0.200
1727,G Dymock (AUS),1974-1980,15,14,1,1,0,0,1,1 (1ct 0st),0.071
1728,RR Emrit (WI),2007-2007,2,2,1,1,0,0,1,1 (1ct 0st),0.500
1729,Fahad Usman (UAE),2004-2004,2,2,1,1,0,0,1,1 (1ct 0st),0.500
1730,Fazle Mahmud (BDESH),2018-2018,2,2,1,1,0,0,1,1 (1ct 0st),0.500
1731,BOP Fernando (SL),2019-2019,6,6,1,1,0,0,1,1 (1ct 0st),0.166
1732,KADM Fernando (SL),2003-2003,1,1,1,1,0,0,1,1 (1ct 0st),1.000
1733,MV Fleming (ENG),1997-1998,11,11,1,1,0,0,1,1 (1ct 0st),0.090
1734,MJ Fourie (IRE),2007-2008,7,6,1,1,0,0,1,1 (1ct 0st),0.166
1735,PJ Franks (ENG),2000-2000,1,1,1,1,0,0,1,1 (1ct 0st),1.000
1736,RS Gabriel (WI),1984-1984,11,11,1,1,0,0,1,1 (1ct 0st),0.090
1737,ST Gabriel (WI),2016-2019,25,25,1,1,0,0,1,1 (1ct 0st),0.040
1738,WCA Ganegama (SL),2001-2006,4,4,1,1,0,0,1,1 (1ct 0st),0.250
1739,TN Garwe (ZIM),2009-2009,1,1,1,1,0,0,1,1 (1ct 0st),1.000
1740,SP Gauchan (NEPAL),2018-2018,1,1,1,1,0,0,1,1 (1ct 0st),1.000
1741,Gazi Ashraf (BDESH),1986-1990,7,7,1,1,0,0,1,1 (1ct 0st),0.142
1742,B Geeves (AUS),2008-2009,2,2,1,1,0,0,1,1 (1ct 0st),0.500
1743,SC Getkate (IRE),2019-2019,3,3,1,1,0,0,1,1 (1ct 0st),0.333
1744,N Gifford (ENG),1985-1985,2,2,1,1,0,0,1,1 (1ct 0st),0.500
1745,BD Glover (NL),2019-2019,1,1,1,1,0,0,1,1 (1ct 0st),1.000
1746,SF Graf (AUS),1980-1981,11,11,1,1,0,0,1,1 (1ct 0st),0.090
1747,AP Grayson (ENG),2000-2001,2,2,1,1,0,0,1,1 (1ct 0st),0.500
1748,Gurkeerat Singh (INDIA),2016-2016,3,3,1,1,0,0,1,1 (1ct 0st),0.333
1749,HF Gurney (ENG),2014-2014,10,10,1,1,0,0,1,1 (1ct 0st),0.100
1750,Gursharan Singh (INDIA),1990-1990,1,1,1,1,0,0,1,1 (1ct 0st),1.000
1751,AM Guruge (UAE),2014-2015,7,7,1,1,0,0,1,1 (1ct 0st),0.142
1752,RS Haire (IRE),2008-2008,2,2,1,1,0,0,1,1 (1ct 0st),0.500
1753,JV Harris (CAN),2003-2003,6,6,1,1,0,0,1,1 (1ct 0st),0.166
1754,RG Hart (NZ),2002-2002,2,2,1,1,0,1,0,1 (1ct 0st),0.500
1755,Hasan Jamil (PAK),1977-1978,6,6,1,1,0,0,1,1 (1ct 0st),0.166
1756,Hasan Raza (PAK),1996-1999,16,15,1,1,0,0,1,1 (1ct 0st),0.066
1757,TJ Heggelman (NL),2010-2011,5,5,1,1,0,0,1,1 (1ct 0st),0.200
1758,BE Hendricks (SA),2019-2019,4,3,1,1,0,0,1,1 (1ct 0st),0.333
1759,O Henry (SA),1992-1992,3,3,1,1,0,0,1,1 (1ct 0st),0.333
1760,JG Heron (ZIM),1983-1983,6,6,1,1,0,0,1,1 (1ct 0st),0.166
1761,PD Heyn (SL),1975-1975,2,2,1,1,0,0,1,1 (1ct 0st),0.500
1762,AMJ Hilditch (AUS),1979-1985,8,8,1,1,0,0,1,1 (1ct 0st),0.125
1763,KC Hodsoll (BMUDA),2007-2008,3,3,1,1,0,0,1,1 (1ct 0st),0.333
1764,CK Hooper (CAN),2007-2010,5,5,1,1,0,0,1,1 (1ct 0st),0.200
1765,KA Hope (WI),2017-2017,7,7,1,1,0,0,1,1 (1ct 0st),0.142
1766,AG Hurst (AUS),1975-1979,8,7,1,1,0,0,1,1 (1ct 0st),0.142
1767,RO Hussain (SCOT),2006-2010,8,7,1,1,0,0,1,1 (1ct 0st),0.142
1768,KH Butt (HKG),2008-2008,2,2,1,1,0,0,1,1 (1ct 0st),0.500
1769,EH Hutchinson (USA),2019-2019,4,4,1,1,0,0,1,1 (1ct 0st),0.250
1770,DP Hyatt (WI),2011-2011,9,9,1,1,0,0,1,1 (1ct 0st),0.111
1771,AP Igglesden (ENG),1994-1994,4,4,1,1,0,0,1,1 (1ct 0st),0.250
1772,Ijaz Ahmed jnr (PAK),1997-1997,2,2,1,1,0,0,1,1 (1ct 0st),0.500
1773,R Illingworth (ENG),1971-1973,3,2,1,1,0,0,1,1 (1ct 0st),0.500
1774,Imran Abbas (PAK),2000-2000,2,2,1,1,0,0,1,1 (1ct 0st),0.500
1775,MM Iqbal (SCOT),2009-2014,13,13,1,1,0,0,1,1 (1ct 0st),0.076
1776,Irfan Bhatti (PAK),1993-1993,1,1,1,1,0,0,1,1 (1ct 0st),1.000
1777,Izatullah Dawlatzai (AFG),2010-2015,5,5,1,1,0,0,1,1 (1ct 0st),0.200
1778,Jahangir Alam (BDESH),1997-1999,3,3,1,0,1,0,0,1 (0ct 1st),0.333
1779,Jahangir Shah (BDESH),1986-1990,5,5,1,1,0,0,1,1 (1ct 0st),0.200
1780,Jalal-ud-Din (PAK),1982-1983,8,7,1,1,0,0,1,1 (1ct 0st),0.142
1781,Jamaluddin Ahmed (BDESH),2003-2003,1,1,1,1,0,0,1,1 (1ct 0st),1.000
1782,F Jansen (NL),1996-1996,2,2,1,1,0,0,1,1 (1ct 0st),0.500
1783,MP Jarvis (ZIM),1987-1995,12,12,1,1,0,0,1,1 (1ct 0st),0.083
1784,PW Jarvis (ENG),1988-1993,16,16,1,1,0,0,1,1 (1ct 0st),0.062
1785,Javed Qadeer (PAK),1995-1995,1,1,1,1,0,1,0,1 (1ct 0st),1.000
1786,SA Jayasinghe (SL),1979-1979,2,2,1,1,0,1,0,1 (1ct 0st),0.500
1787,GSNFG Jayasuriya (SL),2015-2019,12,12,1,1,0,0,1,1 (1ct 0st),0.083
1788,Jay Odedra (OMAN),2019-2019,2,2,1,1,0,0,1,1 (1ct 0st),0.500
1789,S Jeganathan (SL),1983-1988,5,5,1,1,0,0,1,1 (1ct 0st),0.200
1790,MR Johnson (USA),2004-2004,2,2,1,1,0,1,0,1 (1ct 0st),0.500
1791,MBS Jonkman (NL),2006-2010,16,16,1,1,0,0,1,1 (1ct 0st),0.062
1792,MMA Jonkman (NL),2007-2010,4,4,1,1,0,0,1,1 (1ct 0st),0.250
1793,DI Joyce (IRE),2006-2007,3,3,1,1,0,0,1,1 (1ct 0st),0.333
1794,Jubair Hossain (BDESH),2014-2015,3,3,1,1,0,0,1,1 (1ct 0st),0.333
1795,Kabir Khan (PAK),1994-2000,10,9,1,1,0,0,1,1 (1ct 0st),0.111
1796,Kamran Shazad (UAE),2014-2015,4,4,1,1,0,0,1,1 (1ct 0st),0.250
1797,AR Kapoor (INDIA),1995-2000,17,17,1,1,0,0,1,1 (1ct 0st),0.058
1798,M Karg (NAM),2003-2003,3,3,1,1,0,1,0,1 (1ct 0st),0.333
1799,SHU Karnain (SL),1984-1990,19,19,1,1,0,0,1,1 (1ct 0st),0.052
1800,S Kaul (INDIA),2018-2018,3,3,1,1,0,0,1,1 (1ct 0st),0.333
1801,RJ Kennedy (NZ),1996-1996,7,7,1,1,0,0,1,1 (1ct 0st),0.142
1802,JC Kent (SA),2002-2002,2,2,1,1,0,0,1,1 (1ct 0st),0.500
1803,RB Kerr (AUS),1985-1985,4,4,1,1,0,0,1,1 (1ct 0st),0.250
1804,S Keshvani (CAN),2009-2009,5,4,1,1,0,0,1,1 (1ct 0st),0.250
1805,SP Khakurel (NEPAL),2018-2018,2,2,1,0,1,0,0,1 (0ct 1st),0.500
1806,Khalid Latif (PAK),2008-2010,5,5,1,1,0,0,1,1 (1ct 0st),0.200
1807,Khawar Ali (OMAN),2019-2019,5,5,1,1,0,0,1,1 (1ct 0st),0.200
1808,Khurram Nawaz (OMAN),2019-2019,3,3,1,1,0,0,1,1 (1ct 0st),0.333
1809,GE Kidd (IRE),2007-2008,6,5,1,1,0,0,1,1 (1ct 0st),0.200
1810,J Kila (PNG),2018-2019,6,6,1,1,0,0,1,1 (1ct 0st),0.166
1811,VJ Kingma (NL),2014-2019,3,3,1,1,0,0,1,1 (1ct 0st),0.333
1812,JF Kloppenburg (NL),2002-2003,6,6,1,1,0,0,1,1 (1ct 0st),0.166
1813,BL Kotze (NAM),2003-2003,5,5,1,1,0,0,1,1 (1ct 0st),0.200
1814,GJP Kruger (SA),2006-2006,3,3,1,1,0,0,1,1 (1ct 0st),0.333
1815,CKB Kulasekara (SL),2011-2012,4,4,1,1,0,0,1,1 (1ct 0st),0.250
1816,S Lamichhane (NEPAL),2018-2019,6,6,1,1,0,0,1,1 (1ct 0st),0.166
1817,JPR Lamsam (HKG),2004-2008,2,2,1,1,0,0,1,1 (1ct 0st),0.500
1818,WM Lawry (AUS),1971-1971,1,1,1,1,0,0,1,1 (1ct 0st),1.000
1819,ML Lewis (AUS),2005-2006,7,7,1,1,0,0,1,1 (1ct 0st),0.142
1820,ACI Lock (ZIM),1996-1996,8,7,1,1,0,0,1,1 (1ct 0st),0.142
1821,JL Louw (NAM),2003-2003,1,1,1,1,0,0,1,1 (1ct 0st),1.000
1822,JD Love (ENG),1981-1981,3,3,1,1,0,0,1,1 (1ct 0st),0.333
1823,SW Lubbers (NL),1996-1996,4,4,1,1,0,0,1,1 (1ct 0st),0.250
1824,MJ Lumb (ENG),2014-2014,3,3,1,1,0,0,1,1 (1ct 0st),0.333
1825,AS Luseno (KENYA),2003-2010,10,10,1,1,0,0,1,1 (1ct 0st),0.100
1826,MA Lynch (ENG),1988-1988,3,3,1,1,0,0,1,1 (1ct 0st),0.333
1827,RJ McCurdy (AUS),1985-1985,11,11,1,1,0,0,1,1 (1ct 0st),0.090
1828,PE McEwan (NZ),1980-1985,17,17,1,1,0,0,1,1 (1ct 0st),0.058
1829,AJ Mackay (ZIM),2001-2001,3,3,1,1,0,0,1,1 (1ct 0st),0.333
1830,GD McKenzie (AUS),1971-1971,1,1,1,1,0,0,1,1 (1ct 0st),1.000
1831,DL Maddy (ENG),1998-2000,8,8,1,1,0,0,1,1 (1ct 0st),0.125
1832,Mafizur Rahman (BDESH),1997-1997,4,4,1,1,0,0,1,1 (1ct 0st),0.250
1833,Mahbubul Alam (BDESH),2009-2009,5,5,1,1,0,0,1,1 (1ct 0st),0.200
1834,SI Mahmood (ENG),2004-2009,26,26,1,1,0,0,1,1 (1ct 0st),0.038
1835,GT Main (SCOT),2019-2019,1,1,1,1,0,0,1,1 (1ct 0st),1.000
1836,DE Malcolm (ENG),1990-1994,10,10,1,1,0,0,1,1 (1ct 0st),0.100
1837,MF Malone (AUS),1977-1982,10,10,1,1,0,0,1,1 (1ct 0st),0.100
1838,Manzoor Akhtar (PAK),1997-1998,7,7,1,1,0,0,1,1 (1ct 0st),0.142
1839,PJ Martin (ENG),1995-1998,20,20,1,1,0,0,1,1 (1ct 0st),0.050
1840,RAL Massie (AUS),1972-1972,3,3,1,1,0,0,1,1 (1ct 0st),0.333
1841,EZ Matambanadzo (ZIM),1996-1997,7,7,1,1,0,0,1,1 (1ct 0st),0.142
1842,Mazhar Hussain (UAE),1994-1996,7,7,1,1,0,0,1,1 (1ct 0st),0.142
1843,JA McCollum (IRE),2019-2019,8,8,1,1,0,0,1,1 (1ct 0st),0.125
1844,V Mehra (UAE),1994-1996,6,6,1,1,0,0,1,1 (1ct 0st),0.166
1845,KO Meth (ZIM),2006-2012,11,11,1,1,0,0,1,1 (1ct 0st),0.090
1846,JP Millmow (NZ),1990-1990,5,5,1,1,0,0,1,1 (1ct 0st),0.200
1847,A Mithun (INDIA),2010-2011,5,5,1,1,0,0,1,1 (1ct 0st),0.200
1848,Mohammad Boota (UAE),2018-2019,9,9,1,0,1,0,0,1 (0ct 1st),0.111
1849,Mohammad Hasnain (PAK),2019-2019,5,5,1,1,0,0,1,1 (1ct 0st),0.200
1850,Mohammad Ishaq (UAE),1994-1996,5,5,1,1,0,0,1,1 (1ct 0st),0.200
1851,Mohammad Nadeem (OMAN),2019-2019,4,4,1,1,0,0,1,1 (1ct 0st),0.250
1852,Mohammad Salim (BDESH),2003-2003,1,1,1,1,0,1,0,1 (1ct 0st),1.000
1853,Mohammad Sharif (BDESH),2001-2007,9,9,1,1,0,0,1,1 (1ct 0st),0.111
1854,Mohammad Zahid (PAK),1996-2002,11,11,1,1,0,0,1,1 (1ct 0st),0.090
1855,D Mohammed (WI),2006-2008,7,7,1,1,0,0,1,1 (1ct 0st),0.142
1856,Mosharraf Hossain (BDESH),2008-2016,5,5,1,1,0,0,1,1 (1ct 0st),0.200
1857,TV Mufambisi (ZIM),2006-2007,6,6,1,1,0,1,0,1 (1ct 0st),0.166
1858,SP Mukherjee (INDIA),1990-1991,3,3,1,1,0,0,1,1 (1ct 0st),0.333
1859,J Mulder (IRE),2017-2017,4,4,1,1,0,0,1,1 (1ct 0st),0.250
1860,CT Mumba (ZIM),2016-2017,2,2,1,1,0,0,1,1 (1ct 0st),0.500
1861,N M'shangwe (ZIM),2011-2014,6,6,1,1,0,0,1,1 (1ct 0st),0.166
1862,DT Mutendera (ZIM),1999-2001,9,9,1,1,0,0,1,1 (1ct 0st),0.111
1863,G Mylvaganam (UAE),1996-1996,3,3,1,1,0,0,1,1 (1ct 0st),0.333
1864,Naeemuddin Aslam (UAE),2004-2004,2,2,1,1,0,0,1,1 (1ct 0st),0.500
1865,Naeem Ahmed (PAK),1978-1978,1,1,1,1,0,0,1,1 (1ct 0st),1.000
1866,Najeeb Amar (HKG),2004-2008,4,4,1,1,0,0,1,1 (1ct 0st),0.250
1867,BP Nash (WI),2008-2009,9,8,1,1,0,0,1,1 (1ct 0st),0.125
1868,SV Nayak (INDIA),1981-1982,4,4,1,1,0,0,1,1 (1ct 0st),0.250
1869,Nazimuddin (BDESH),2008-2012,11,11,1,1,0,0,1,1 (1ct 0st),0.090
1870,Neeyamur Rashid (BDESH),1999-1999,2,2,1,1,0,0,1,1 (1ct 0st),0.500
1871,A Neill (SCOT),2019-2019,1,1,1,1,0,0,1,1 (1ct 0st),1.000
1872,R Ngarava (ZIM),2017-2018,9,9,1,1,0,0,1,1 (1ct 0st),0.111
1873,Noor-ul-Haq (AFG),2010-2010,2,2,1,1,0,0,1,1 (1ct 0st),0.500
1874,MJ North (AUS),2009-2009,2,2,1,1,0,0,1,1 (1ct 0st),0.500
1875,GH O'Brien (BMUDA),2006-2008,9,9,1,1,0,0,1,1 (1ct 0st),0.111
1876,IE O'Brien (NZ),2008-2009,10,10,1,1,0,0,1,1 (1ct 0st),0.100
1877,NM Odhiambo (KENYA),2010-2013,8,8,1,1,0,0,1,1 (1ct 0st),0.125
1878,NV Ojha (INDIA),2010-2010,1,1,1,0,1,0,0,1 (0ct 1st),1.000
1879,LN Oluoch (KENYA),2011-2011,2,2,1,1,0,0,1,1 (1ct 0st),0.500
1880,G Onions (ENG),2009-2009,4,4,1,1,0,0,1,1 (1ct 0st),0.250
1881,Pankaj Singh (INDIA),2010-2010,1,1,1,1,0,0,1,1 (1ct 0st),1.000
1882,MHW Papps (NZ),2004-2005,6,6,1,1,0,0,1,1 (1ct 0st),0.166
1883,JS Paris (AUS),2016-2016,2,2,1,1,0,0,1,1 (1ct 0st),0.500
1884,NM Parker (NZ),1976-1976,1,1,1,1,0,0,1,1 (1ct 0st),1.000
1885,AK Patel (INDIA),1984-1985,8,7,1,1,0,0,1,1 (1ct 0st),0.142
1886,BP Patel (INDIA),1974-1979,10,10,1,1,0,0,1,1 (1ct 0st),0.100
1887,NK Patel (USA),2019-2019,4,4,1,1,0,0,1,1 (1ct 0st),0.250
1888,J Patraj (CAN),2007-2007,2,2,1,1,0,0,1,1 (1ct 0st),0.500
1889,SG Peall (ZIM),1992-1996,21,20,1,1,0,0,1,1 (1ct 0st),0.050
1890,AJ Penn (NZ),1997-2001,5,5,1,1,0,0,1,1 (1ct 0st),0.200
1891,AK Perera (SL),2013-2019,6,6,1,1,0,0,1,1 (1ct 0st),0.166
1892,PARP Perera (SL),2019-2019,2,2,1,1,0,0,1,1 (1ct 0st),0.500
1893,V Permaul (WI),2012-2017,7,7,1,1,0,0,1,1 (1ct 0st),0.142
1894,AR Pitcher (BMUDA),2006-2007,4,4,1,1,0,0,1,1 (1ct 0st),0.250
1895,V Pollard (NZ),1973-1974,3,3,1,1,0,0,1,1 (1ct 0st),0.333
1896,RH Poonawala (UAE),1994-1994,2,2,1,1,0,0,1,1 (1ct 0st),0.500
1897,GD Porter (AUS),1979-1979,2,2,1,1,0,0,1,1 (1ct 0st),0.500
1898,KTGD Prasad (SL),2006-2015,24,24,1,1,0,0,1,1 (1ct 0st),0.041
1899,AG Puttick (SA),2005-2005,1,1,1,1,0,0,1,1 (1ct 0st),1.000
1900,Qadeer Ahmed (UAE),2015-2019,11,11,1,1,0,0,1,1 (1ct 0st),0.090
1901,Rahat Ali (PAK),2012-2016,14,14,1,1,0,0,1,1 (1ct 0st),0.071
1902,P Raho (PNG),2014-2014,1,1,1,1,0,0,1,1 (1ct 0st),1.000
1903,LN Rajbanshi (NEPAL),2019-2019,3,3,1,1,0,0,1,1 (1ct 0st),0.333
1904,CAK Rajitha (SL),2018-2019,9,9,1,1,0,0,1,1 (1ct 0st),0.111
1905,SK Ranasinghe (SL),1986-1986,4,4,1,1,0,0,1,1 (1ct 0st),0.250
1906,D Ranatunga (SL),1990-1990,4,4,1,1,0,0,1,1 (1ct 0st),0.250
1907,U Ranchod (ZIM),1992-1993,3,3,1,1,0,0,1,1 (1ct 0st),0.333
1908,Raqibul Hasan (BDESH),1986-1986,2,2,1,1,0,0,1,1 (1ct 0st),0.500
1909,JB Reva (PNG),2016-2018,9,9,1,1,0,0,1,1 (1ct 0st),0.111
1910,ACL Richards (WI),2007-2007,1,1,1,1,0,0,1,1 (1ct 0st),1.000
1911,MH Richardson (NZ),2002-2002,4,4,1,1,0,0,1,1 (1ct 0st),0.250
1912,Rizwan Ahmed (PAK),2008-2008,1,1,1,1,0,0,1,1 (1ct 0st),1.000
1913,ADG Roberts (NZ),1976-1976,1,1,1,1,0,0,1,1 (1ct 0st),1.000
1914,RJ Robinson (BMUDA),2007-2009,3,3,1,1,0,0,1,1 (1ct 0st),0.333
1915,LN Roche (ZIM),2018-2018,3,3,1,1,0,0,1,1 (1ct 0st),0.333
1916,Rokhan Barakzai (AFG),2015-2015,1,1,1,1,0,0,1,1 (1ct 0st),1.000
1917,LC Romero (USA),2004-2004,2,2,1,1,0,0,1,1 (1ct 0st),0.500
1918,BC Rose (ENG),1977-1977,2,2,1,1,0,0,1,1 (1ct 0st),0.500
1919,MW Rushmere (SA),1992-1992,4,4,1,1,0,0,1,1 (1ct 0st),0.250
1920,Saadat Ali (PAK),1984-1984,8,8,1,1,0,0,1,1 (1ct 0st),0.125
1921,Saeed-al-Saffar (UAE),1996-1996,1,1,1,1,0,0,1,1 (1ct 0st),1.000
1922,Sajid Ali (PAK),1984-1997,13,13,1,1,0,0,1,1 (1ct 0st),0.076
1923,Saleem Altaf (PAK),1973-1978,6,6,1,1,0,0,1,1 (1ct 0st),0.166
1924,IDK Salisbury (ENG),1993-1994,4,4,1,1,0,0,1,1 (1ct 0st),0.250
1925,G Salmond (SCOT),1999-1999,5,5,1,1,0,0,1,1 (1ct 0st),0.200
1926,JA Samarasekera (UAE),1994-1996,7,7,1,1,0,0,1,1 (1ct 0st),0.142
1927,S Samarawickrama (SL),2017-2019,7,7,1,1,0,0,1,1 (1ct 0st),0.142
1928,Samiur Rahman (BDESH),1986-1986,2,2,1,1,0,0,1,1 (1ct 0st),0.500
1929,RG Samuels (WI),1996-1997,8,8,1,1,0,0,1,1 (1ct 0st),0.125
1930,KT Sandher (CAN),2006-2007,15,15,1,1,0,0,1,1 (1ct 0st),0.066
1931,BB Seebaran (CAN),2003-2003,4,4,1,1,0,0,1,1 (1ct 0st),0.250
1932,CS Serjeant (AUS),1977-1978,3,3,1,1,0,0,1,1 (1ct 0st),0.333
1933,RK Sethi (EAf),1975-1975,3,3,1,1,0,0,1,1 (1ct 0st),0.333
1934,Shadab Kabir (PAK),1996-1996,3,3,1,1,0,0,1,1 (1ct 0st),0.333
1935,Shafiq Ahmed (PAK),1977-1978,3,3,1,1,0,0,1,1 (1ct 0st),0.333
1936,KD Shah (HKG),2014-2018,10,10,1,1,0,0,1,1 (1ct 0st),0.100
1937,Shahid Mahboob (PAK),1982-1984,10,10,1,1,0,0,1,1 (1ct 0st),0.100
1938,Shan Masood (PAK),2019-2019,5,5,1,1,0,0,1,1 (1ct 0st),0.200
1939,R Sharma (HKG),2004-2004,2,2,1,1,0,0,1,1 (1ct 0st),0.500
1940,R Sharma (INDIA),2011-2012,4,4,1,1,0,0,1,1 (1ct 0st),0.250
1941,DJM Short (AUS),2018-2018,4,4,1,1,0,0,1,1 (1ct 0st),0.250
1942,LR Shukla (INDIA),1999-1999,3,3,1,1,0,0,1,1 (1ct 0st),0.333
1943,K Shuttleworth (ENG),1971-1971,1,1,1,1,0,0,1,1 (1ct 0st),1.000
1944,PM Siddle (AUS),2009-2019,20,19,1,1,0,0,1,1 (1ct 0st),0.052
1945,RW Sims (ZIM),2002-2003,3,3,1,1,0,0,1,1 (1ct 0st),0.333
1946,MA Small (WI),1984-1984,2,2,1,1,0,0,1,1 (1ct 0st),0.500
1947,MJ Smith (ENG),1973-1974,5,5,1,1,0,0,1,1 (1ct 0st),0.200
1948,NMK Smith (ENG),1996-1996,7,7,1,1,0,0,1,1 (1ct 0st),0.142
1949,JA Snow (ENG),1971-1975,9,8,1,1,0,0,1,1 (1ct 0st),0.125
1950,GS Sobers (WI),1973-1973,1,1,1,1,0,0,1,1 (1ct 0st),1.000
1951,Sohail Fazal (PAK),1989-1989,2,2,1,1,0,0,1,1 (1ct 0st),0.500
1952,Sompal Kami (NEPAL),2018-2019,6,6,1,1,0,0,1,1 (1ct 0st),0.166
1953,D Soraine (CAN),2006-2012,4,4,1,1,0,0,1,1 (1ct 0st),0.250
1954,BB Sran (INDIA),2016-2016,6,6,1,1,0,0,1,1 (1ct 0st),0.166
1955,L Sreekumar (UAE),2015-2016,4,4,1,1,0,0,1,1 (1ct 0st),0.250
1956,S Sriram (INDIA),2000-2004,8,8,1,1,0,0,1,1 (1ct 0st),0.125
1957,KR Stackpole (AUS),1971-1974,6,6,1,1,0,0,1,1 (1ct 0st),0.166
1958,JH Stander (SCOT),2009-2012,5,5,1,1,0,0,1,1 (1ct 0st),0.200
1959,B Stanlake (AUS),2017-2019,7,7,1,1,0,0,1,1 (1ct 0st),0.142
1960,LW Stokkers (NL),2008-2008,1,1,1,1,0,0,1,1 (1ct 0st),1.000
1961,LW Stott (NZ),1979-1979,1,1,1,1,0,0,1,1 (1ct 0st),1.000
1962,CEL Stuart (WI),2001-2001,5,5,1,1,0,0,1,1 (1ct 0st),0.200
1963,ML Su'a (NZ),1992-1995,12,12,1,1,0,0,1,1 (1ct 0st),0.083
1964,R Sudhakar Rao (INDIA),1976-1976,1,1,1,1,0,0,1,1 (1ct 0st),1.000
1965,Syed Maqsood (UAE),2004-2004,2,2,1,1,0,0,1,1 (1ct 0st),0.500
1966,Taijul Islam (BDESH),2014-2019,6,6,1,1,0,0,1,1 (1ct 0st),0.166
1967,Talha Jubair (BDESH),2002-2003,6,6,1,1,0,0,1,1 (1ct 0st),0.166
1968,Tanbir Hayder (BDESH),2016-2016,2,2,1,1,0,0,1,1 (1ct 0st),0.500
1969,Tanvir Ahmed (PAK),2011-2011,2,2,1,1,0,0,1,1 (1ct 0st),0.500
1970,BR Taylor (NZ),1973-1973,2,2,1,1,0,0,1,1 (1ct 0st),0.500
1971,GJ Thompson (IRE),2008-2008,3,3,1,1,0,0,1,1 (1ct 0st),0.333
1972,FJ Titmus (ENG),1975-1975,2,2,1,1,0,0,1,1 (1ct 0st),0.500
1973,RW Tolchard (ENG),1979-1979,1,1,1,1,0,1,0,1 (1ct 0st),1.000
1974,CP Tremain (AUS),2016-2016,4,4,1,1,0,0,1,1 (1ct 0st),0.250
1975,JO Troughton (ENG),2003-2003,6,5,1,1,0,0,1,1 (1ct 0st),0.200
1976,AJ Tudor (ENG),2002-2002,3,3,1,1,0,0,1,1 (1ct 0st),0.333
1977,AJ Turner (AUS),2019-2019,3,3,1,1,0,0,1,1 (1ct 0st),0.333
1978,S Tyagi (INDIA),2009-2010,4,4,1,1,0,0,1,1 (1ct 0st),0.250
1979,AJ Tye (AUS),2018-2018,7,7,1,1,0,0,1,1 (1ct 0st),0.142
1980,SD Udal (ENG),1994-2005,11,11,1,1,0,0,1,1 (1ct 0st),0.090
1981,Umair Ali (UAE),2015-2015,2,2,1,1,0,0,1,1 (1ct 0st),0.500
1982,Usman Salahuddin (PAK),2011-2011,2,2,1,1,0,0,1,1 (1ct 0st),0.500
1983,JN Valentine (CAN),1979-1979,3,3,1,1,0,0,1,1 (1ct 0st),0.333
1984,A van der Merwe (IRE),2010-2011,9,9,1,1,0,0,1,1 (1ct 0st),0.111
1985,VB van Jaarsveld (SA),2009-2009,2,2,1,1,0,0,1,1 (1ct 0st),0.500
1986,TP Visee (NL),2019-2019,2,2,1,1,0,0,1,1 (1ct 0st),0.500
1987,AL Wadekar (INDIA),1974-1974,2,2,1,1,0,0,1,1 (1ct 0st),0.500
1988,I Wardlaw (SCOT),2013-2015,22,21,1,1,0,0,1,1 (1ct 0st),0.047
1989,Washington Sundar (INDIA),2017-2017,1,1,1,1,0,0,1,1 (1ct 0st),1.000
1990,SR Welsh (CAN),2006-2008,3,3,1,1,0,0,1,1 (1ct 0st),0.333
1991,BA Westdijk (NL),2011-2011,4,4,1,1,0,0,1,1 (1ct 0st),0.250
1992,AG Wharf (ENG),2004-2005,13,13,1,1,0,0,1,1 (1ct 0st),0.076
1993,BM Wheeler (NZ),2015-2015,6,6,1,1,0,0,1,1 (1ct 0st),0.166
1994,JJ Whitaker (ENG),1987-1987,2,2,1,1,0,0,1,1 (1ct 0st),0.500
1995,DJ White (NZ),1990-1990,3,3,1,1,0,0,1,1 (1ct 0st),0.333
1996,P Wilson (AUS),1997-1998,11,11,1,1,0,0,1,1 (1ct 0st),0.090
1997,WA Wisneski (NZ),2000-2000,3,3,1,1,0,0,1,1 (1ct 0st),0.333
1998,DJ Worrall (AUS),2016-2016,3,3,1,1,0,0,1,1 (1ct 0st),0.333
1999,CM Wright (SCOT),2006-2009,20,20,1,1,0,0,1,1 (1ct 0st),0.050
2000,M Yachad (SA),1991-1991,1,1,1,1,0,0,1,1 (1ct 0st),1.000
2001,J Yadav (INDIA),2016-2016,1,1,1,1,0,0,1,1 (1ct 0st),1.000
2002,NS Yadav (INDIA),1986-1987,7,7,1,1,0,0,1,1 (1ct 0st),0.142
2003,B Yardley (AUS),1978-1983,7,5,1,1,0,0,1,1 (1ct 0st),0.200
2004,Younis Ahmed (PAK),1987-1987,2,2,1,1,0,0,1,1 (1ct 0st),0.500
2005,Zafar Iqbal (PAK),1995-1995,8,8,1,1,0,0,1,1 (1ct 0st),0.125
2006,Zahid Hussain (CAN),2011-2011,2,2,1,1,0,0,1,1 (1ct 0st),0.500
2007,Sultan Zarawani (UAE),1994-1996,7,7,1,1,0,0,1,1 (1ct 0st),0.142
2008,AK Zesers (AUS),1987-1987,2,2,1,1,0,0,1,1 (1ct 0st),0.500
2009,C Zhuwao (ZIM),2008-2018,9,9,1,1,0,0,1,1 (1ct 0st),0.111
2010,K Zondo (SA),2018-2018,5,5,1,1,0,0,1,1 (1ct 0st),0.200
2011,Zulfiqar Ali (EAf),1975-1975,3,3,1,1,0,0,1,1 (1ct 0st),0.333
2012,Aamer Hanif (PAK),1993-1995,5,5,0,0,0,0,0,0,0.000
2013,Aamer Nazir (PAK),1993-1995,9,9,0,0,0,0,0,0,0.000
2014,Aamer Yamin (PAK),2015-2018,4,4,0,0,0,0,0,0,0.000
2015,Aaron Jones (USA),2019-2019,5,5,0,0,0,0,0,0,0.000
2016,SA Abbott (AUS),2014-2014,1,1,0,0,0,0,0,0,0.000
2017,Abdul Rehman (UAE),2004-2004,1,1,0,0,0,0,0,0,0.000
2018,S Abid Ali (INDIA),1974-1975,5,5,0,0,0,0,0,0,0.000
2019,Abu Jayed (BDESH),2019-2019,2,2,0,0,0,0,0,0,0.000
2020,FS Ahangama (SL),1985-1985,1,1,0,0,0,0,0,0,0.000
2021,Ahmed Kamal (BDESH),1999-1999,1,1,0,0,0,0,0,0,0.000
2022,Ahmed Shah (AFG),2009-2009,1,1,0,0,0,0,0,0,0.000
2023,Akhtar Sarfraz (PAK),1997-1998,4,4,0,0,0,0,0,0,0.000
2024,Alawi Shukri (UAE),2008-2008,1,1,0,0,0,0,0,0,0.000
2025,GW Aldridge (NZ),2011-2011,2,2,0,0,0,0,0,0,0.000
2026,RP Alexander (USA),2004-2004,2,2,0,0,0,0,0,0,0.000
2027,Ali Asad (UAE),2004-2004,2,2,0,0,0,0,0,0,0.000
2028,Ali Khan (USA),2019-2019,1,1,0,0,0,0,0,0,0.000
2029,KN Amalean (SL),1986-1988,8,8,0,0,0,0,0,0,0.000
2030,Aman Ali (UAE),2008-2008,1,1,0,0,0,0,0,0,0.000
2031,Aminul Islam jnr (BDESH),1999-1999,1,1,0,0,0,0,0,0,0.000
2032,J Angel (AUS),1994-1995,3,3,0,0,0,0,0,0,0.000
2033,Anisur Rahman (BDESH),1995-1998,2,2,0,0,0,0,0,0,0.000
2034,ZS Ansari (ENG),2015-2015,1,1,0,0,0,0,0,0,0.000
2035,HAG Anthony (WI),1995-1995,3,3,0,0,0,0,0,0,0.000
2036,Anwar Hossain Monir (BDESH),2002-2002,1,1,0,0,0,0,0,0,0.000
2037,Anwar Hossain (BDESH),2002-2002,1,1,0,0,0,0,0,0,0.000
2038,GJAF Aponso (NL),1996-1996,5,5,0,0,0,0,0,0,0.000
2039,MA Aponso (SL),2016-2018,9,9,0,0,0,0,0,0,0.000
2040,Ariful Haque (BDESH),2018-2018,1,1,0,0,0,0,0,0,0.000
2041,Arshad Pervez (PAK),1978-1978,2,2,0,0,0,0,0,0,0.000
2042,B Arun (INDIA),1986-1987,4,4,0,0,0,0,0,0,0.000
2043,Asad Ali (PAK),2013-2013,4,4,0,0,0,0,0,0,0.000
2044,Asghar Ali (UAE),2004-2004,2,2,0,0,0,0,0,0,0.000
2045,Ashfaq Ahmed (PAK),1994-1994,3,3,0,0,0,0,0,0,0.000
2046,Asif Iqbal (1) (UAE),2015-2015,1,1,0,0,0,0,0,0,0.000
2047,Asif Mahmood (PAK),1998-1998,2,2,0,0,0,0,0,0,0.000
2048,Asim Butt (SCOT),1999-1999,5,5,0,0,0,0,0,0,0.000
2049,Asim Saeed (UAE),2004-2004,2,2,0,0,0,0,0,0,0.000
2050,SK Atai (PNG),2019-2019,2,2,0,0,0,0,0,0,0.000
2051,Ata-ur-Rehman (PAK),1992-1996,30,30,0,0,0,0,0,0,0.000
2052,ID Austin (ENG),1998-1999,9,9,0,0,0,0,0,0,0.000
2053,RA Austin (WI),1978-1978,1,1,0,0,0,0,0,0,0.000
2054,Azmat Rana (PAK),1978-1978,2,2,0,0,0,0,0,0,0.000
2055,MD Bailey (NZ),1998-1998,1,1,0,0,0,0,0,0,0.000
2056,PJ Bakker (NL),1996-1996,5,5,0,0,0,0,0,0,0.000
2057,S Baksh (CAN),1979-1979,1,1,0,0,0,0,0,0,0.000
2058,KMC Bandara (SL),2016-2016,1,1,0,0,0,0,0,0,0.000
2059,MRCN Bandaratilleke (SL),1998-1998,3,3,0,0,0,0,0,0,0.000
2060,OAC Banks (WI),2003-2005,5,5,0,0,0,0,0,0,0.000
2061,KJ Barnett (ENG),1988-1988,1,1,0,0,0,0,0,0,0.000
2062,DM Basden (BMUDA),2007-2007,2,2,0,0,0,0,0,0,0.000
2063,GR Beard (AUS),1981-1981,2,2,0,0,0,0,0,0,0.000
2064,RR Beaton (WI),2017-2017,2,2,0,0,0,0,0,0,0.000
2065,JE Benjamin (ENG),1994-1995,2,2,0,0,0,0,0,0,0.000
2066,MR Benson (ENG),1986-1986,1,1,0,0,0,0,0,0,0.000
2067,A Bhandari (INDIA),2000-2004,2,2,0,0,0,0,0,0,0.000
2068,LS Bhandari (NEPAL),2018-2018,1,1,0,0,0,0,0,0,0.000
2069,M Bhanuka (SL),2019-2019,1,1,0,0,0,0,0,0,0.000
2070,Bhupinder Singh snr (INDIA),1994-1994,2,2,0,0,0,0,0,0,0.000
2071,Bilal Khan (OMAN),2019-2019,4,4,0,0,0,0,0,0,0.000
2072,K Birkenstock (NAM),2019-2019,5,5,0,0,0,0,0,0,0.000
2073,MI Black (WI),2001-2001,5,5,0,0,0,0,0,0,0.000
2074,DL Blake (USA),2004-2004,1,1,0,0,0,0,0,0,0.000
2075,G Blakeney (BMUDA),2009-2009,2,2,0,0,0,0,0,0,0.000
2076,SG Borthwick (ENG),2011-2011,2,2,0,0,0,0,0,0,0.000
2077,T Bosch (SA),1992-1992,2,2,0,0,0,0,0,0,0.000
2078,GK Bose (INDIA),1974-1974,1,1,0,0,0,0,0,0,0.000
2079,KD Boyce (WI),1973-1975,8,8,0,0,0,0,0,0,0.000
2080,BP Bracewell (NZ),1978-1978,1,1,0,0,0,0,0,0,0.000
2081,GA Briant (ZIM),1993-1993,5,5,0,0,0,0,0,0,0.000
2082,DR Briggs (ENG),2012-2012,1,1,0,0,0,0,0,0,0.000
2083,SA Britton (IRE),2009-2009,1,1,0,0,0,0,0,0,0.000
2084,D Brown (WI),2001-2002,3,3,0,0,0,0,0,0,0.000
2085,BS Browne (WI),1994-1994,4,4,0,0,0,0,0,0,0.000
2086,GK Bruk-Jackson (ZIM),1993-1993,1,1,0,0,0,0,0,0,0.000
2087,DE Budge (SCOT),2018-2018,1,1,0,0,0,0,0,0,0.000
2088,AJ Burger (NAM),2003-2003,6,6,0,0,0,0,0,0,0.000
2089,AR Butcher (ENG),1980-1980,1,1,0,0,0,0,0,0,0.000
2090,RO Butcher (ENG),1980-1981,3,3,0,0,0,0,0,0,0.000
2091,DK Butler (WI),2005-2006,5,5,0,0,0,0,0,0,0.000
2092,RG Callender (CAN),1979-1979,2,2,0,0,0,0,0,0,0.000
2093,JD Campbell (WI),2019-2019,6,5,0,0,0,0,0,0,0.000
2094,PE Cantrell (NL),1996-1996,5,5,0,0,0,0,0,0,0.000
2095,PH Carlson (AUS),1979-1979,4,3,0,0,0,0,0,0,0.000
2096,NM Carter (SCOT),2013-2013,3,3,0,0,0,0,0,0,0.000
2097,DL Chahar (INDIA),2018-2018,1,1,0,0,0,0,0,0,0.000
2098,SJ Chalmers (SCOT),2009-2009,2,2,0,0,0,0,0,0,0.000
2099,BS Chandrasekhar (INDIA),1976-1976,1,1,0,0,0,0,0,0,0.000
2100,VB Chandrasekhar (INDIA),1988-1990,7,7,0,0,0,0,0,0,0.000
2101,CJD Chappell (CAN),1979-1979,3,3,0,0,0,0,0,0,0.000
2102,G Chapple (ENG),2006-2006,1,1,0,0,0,0,0,0,0.000
2103,M Cheruparambil (HKG),2004-2004,2,2,0,0,0,0,0,0,0.000
2104,MT Chinouya (ZIM),2013-2013,2,2,0,0,0,0,0,0,0.000
2105,K Christie (HKG),2016-2016,1,1,0,0,0,0,0,0,0.000
2106,WM Clark (AUS),1978-1978,2,2,0,0,0,0,0,0,0.000
2107,A Codrington (CAN),2003-2007,9,9,0,0,0,0,0,0,0.000
2108,DJ Colley (AUS),1972-1972,1,1,0,0,0,0,0,0,0.000
2109,BE Congdon (NZ),1973-1978,11,11,0,0,0,0,0,0,0.000
2110,AN Connolly (AUS),1971-1971,1,1,0,0,0,0,0,0,0.000
2111,GA Cope (ENG),1977-1978,2,2,0,0,0,0,0,0,0.000
2112,MJ Cosgrove (AUS),2006-2006,3,3,0,0,0,0,0,0,0.000
2113,CS Cowdrey (ENG),1985-1985,3,3,0,0,0,0,0,0,0.000
2114,MC Cowdrey (ENG),1971-1971,1,1,0,0,0,0,0,0,0.000
2115,RT Crandon (WI),2009-2009,1,1,0,0,0,0,0,0,0.000
2116,FS Crockwell (BMUDA),2009-2009,2,2,0,0,0,0,0,0,0.000
2117,SM Curran (ENG),2018-2018,2,2,0,0,0,0,0,0,0.000
2118,SS Das (INDIA),2001-2002,4,4,0,0,0,0,0,0,0.000
2119,NA David (INDIA),1997-1997,4,4,0,0,0,0,0,0,0.000
2120,RR David (CAN),2008-2010,4,4,0,0,0,0,0,0,0.000
2121,H Davids (SA),2013-2013,2,1,0,0,0,0,0,0,0.000
2122,SG Davies (ZIM),1996-1996,4,4,0,0,0,0,0,0,0.000
2123,IC Davis (AUS),1974-1977,3,3,0,0,0,0,0,0,0.000
2124,Dawlat Ahmadzai (AFG),2009-2010,3,3,0,0,0,0,0,0,0.000
2125,JJ Dawood (CAN),2009-2010,2,1,0,0,0,0,0,0,0.000
2126,LA Dawson (ENG),2016-2018,3,2,0,0,0,0,0,0,0.000
2127,NA de Groot (CAN),2003-2003,6,6,0,0,0,0,0,0,0.000
2128,M de Lange (SA),2012-2016,4,4,0,0,0,0,0,0,0.000
2129,FA Dennis (CAN),1979-1979,3,3,0,0,0,0,0,0,0.000
2130,GN de Silva (SL),1983-1985,4,4,0,0,0,0,0,0,0.000
2131,P Dharmani (INDIA),1996-1996,1,1,0,0,0,0,0,0,0.000
2132,R Dhawan (INDIA),2016-2016,3,3,0,0,0,0,0,0,0.000
2133,HS Dhillon (CAN),2006-2006,2,2,0,0,0,0,0,0,0.000
2134,WP Diepeveen (NL),2011-2011,1,1,0,0,0,0,0,0,0.000
2135,Dolar Mahmud (BDESH),2008-2009,7,7,0,0,0,0,0,0,0.000
2136,BR Dorey (AUS),2006-2006,4,4,0,0,0,0,0,0,0.000
2137,CRM Douglas (BMUDA),2008-2008,2,2,0,0,0,0,0,0,0.000
2138,SO Dowrich (WI),2019-2019,1,1,0,0,0,0,0,0,0.000
2139,BM Duckett (ENG),2016-2016,3,3,0,0,0,0,0,0,0.000
2140,N Dutta (CAN),2013-2013,1,1,0,0,0,0,0,0,0.000
2141,PS Eaglestone (IRE),2008-2008,1,1,0,0,0,0,0,0,0.000
2142,JH Edrich (ENG),1971-1975,7,7,0,0,0,0,0,0,0.000
2143,R Edwards (AUS),1972-1975,9,9,0,0,0,0,0,0,0.000
2144,WJ Edwards (AUS),1975-1975,1,1,0,0,0,0,0,0,0.000
2145,Ehsanul Haque (BDESH),2002-2003,6,6,0,0,0,0,0,0,0.000
2146,Ehsan Adil (PAK),2013-2015,6,6,0,0,0,0,0,0,0.000
2147,Elias Sunny (BDESH),2011-2012,4,4,0,0,0,0,0,0,0.000
2148,MTG Elliott (AUS),1997-1997,1,1,0,0,0,0,0,0,0.000
2149,Fahad Alhashmi (UAE),2008-2015,5,5,0,0,0,0,0,0,0.000
2150,Fahad Nawaz (UAE),2019-2019,2,2,0,0,0,0,0,0,0.000
2151,Faisal Athar (PAK),2003-2003,1,1,0,0,0,0,0,0,0.000
2152,Fawad Ahmed (AUS),2013-2013,3,3,0,0,0,0,0,0,0.000
2153,Fayyaz Ahmed (UAE),2014-2016,3,3,0,0,0,0,0,0,0.000
2154,FY Fazal (INDIA),2016-2016,1,1,0,0,0,0,0,0,0.000
2155,Fazl-e-Akbar (PAK),1998-2001,2,2,0,0,0,0,0,0,0.000
2156,N Fernandes (UAE),2008-2008,1,1,0,0,0,0,0,0,0.000
2157,AM Fernando (SL),2017-2017,1,1,0,0,0,0,0,0,0.000
2158,ER Fernando (SL),1975-1975,3,3,0,0,0,0,0,0,0.000
2159,ERNS Fernando (SL),1983-1983,7,7,0,0,0,0,0,0,0.000
2160,MVT Fernando (SL),2017-2019,8,8,0,0,0,0,0,0,0.000
2161,TL Fernando (SL),1989-1989,1,1,0,0,0,0,0,0,0.000
2162,UNK Fernando (SL),1994-1994,2,2,0,0,0,0,0,0,0.000
2163,R Flannigan (SCOT),2010-2010,1,1,0,0,0,0,0,0,0.000
2164,DAG Fletcher (ZIM),1983-1983,6,6,0,0,0,0,0,0,0.000
2165,MLC Foster (WI),1973-1973,2,2,0,0,0,0,0,0,0.000
2166,TJ Franklin (NZ),1983-1988,3,3,0,0,0,0,0,0,0.000
2167,Frasat Ali (EAf),1975-1975,3,3,0,0,0,0,0,0,0.000
2168,IS Gallage (SL),1999-2001,3,3,0,0,0,0,0,0,0.000
2169,DJ Gandhi (INDIA),1999-2000,3,3,0,0,0,0,0,0,0.000
2170,D Ganesh (INDIA),1997-1997,1,1,0,0,0,0,0,0,0.000
2171,LV Garrick (WI),2001-2001,3,3,0,0,0,0,0,0,0.000
2172,WT Gavera (PNG),2014-2017,4,4,0,0,0,0,0,0,0.000
2173,RS Ghai (INDIA),1984-1986,6,6,0,0,0,0,0,0,0.000
2174,Gholam Nousher (BDESH),1986-1990,9,9,0,0,0,0,0,0,0.000
2175,Ghulam Ali (PAK),1993-1995,3,3,0,0,0,0,0,0,0.000
2176,T Gibbons (BMUDA),2006-2006,2,2,0,0,0,0,0,0,0.000
2177,LR Gibbs (WI),1973-1975,3,3,0,0,0,0,0,0,0.000
2178,PG Gillespie (IRE),2006-2007,5,5,0,0,0,0,0,0,0.000
2179,Golam Faruq (BDESH),1986-1990,5,5,0,0,0,0,0,0,0.000
2180,MS Gony (INDIA),2008-2008,2,2,0,0,0,0,0,0,0.000
2181,Y Goonasekera (SL),1983-1983,3,3,0,0,0,0,0,0,0.000
2182,JOA Gordon (CAN),2012-2014,5,5,0,0,0,0,0,0,0.000
2183,K Gore (USA),2019-2019,5,5,0,0,0,0,0,0,0.000
2184,EL Gouka (NL),1996-1996,3,3,0,0,0,0,0,0,0.000
2185,VD Grandia (NL),2002-2002,1,1,0,0,0,0,0,0,0.000
2186,AE Greenidge (WI),1978-1978,1,1,0,0,0,0,0,0,0.000
2187,RD Gudhka (KENYA),2011-2011,2,2,0,0,0,0,0,0,0.000
2188,FRMD Gunatilleke (SL),1979-1979,1,1,0,0,0,0,0,0,0.000
2189,AAW Gunawardena (SL),1994-1994,1,1,0,0,0,0,0,0,0.000
2190,SK Gupta (KENYA),1996-2001,10,10,0,0,0,0,0,0,0.000
2191,Gurdeep Singh (KENYA),2013-2013,1,1,0,0,0,0,0,0,0.000
2192,Haafiz Shahid (PAK),1988-1988,3,3,0,0,0,0,0,0,0.000
2193,BG Hadlee (NZ),1975-1975,2,2,0,0,0,0,0,0,0.000
2194,OJ Hairs (SCOT),2010-2010,5,5,0,0,0,0,0,0,0.000
2195,JD Hall (IRE),2010-2010,3,3,0,0,0,0,0,0,0.000
2196,LJ Hamilton (NZ),2005-2005,2,2,0,0,0,0,0,0,0.000
2197,JR Hammond (AUS),1972-1972,1,1,0,0,0,0,0,0,0.000
2198,JH Hampshire (ENG),1971-1972,3,3,0,0,0,0,0,0,0.000
2199,Hamza Tahir (SCOT),2019-2019,3,3,0,0,0,0,0,0,0.000
2200,Harilal Shah (EAf),1975-1975,3,3,0,0,0,0,0,0,0.000
2201,RT Hart (NZ),1985-1985,1,1,0,0,0,0,0,0,0.000
2202,Harunur Rashid (BDESH),1988-1988,2,2,0,0,0,0,0,0,0.000
2203,SM Harwood (AUS),2009-2009,1,1,0,0,0,0,0,0,0.000
2204,MJ Haslam (NZ),1992-1992,1,1,0,0,0,0,0,0,0.000
2205,Hasti Gul (AFG),2009-2009,2,2,0,0,0,0,0,0,0.000
2206,FC Hayes (ENG),1973-1975,6,5,0,0,0,0,0,0,0.000
2207,RL Hayes (NZ),1995-1995,1,1,0,0,0,0,0,0,0.000
2208,RGA Headley (WI),1973-1973,1,1,0,0,0,0,0,0,0.000
2209,SD Heazlett (AUS),2017-2017,1,1,0,0,0,0,0,0,0.000
2210,R Hekure (PNG),2019-2019,1,1,0,0,0,0,0,0,0.000
2211,CW Henderson (SA),2001-2001,4,4,0,0,0,0,0,0,0.000
2212,CC Henry (CAN),1979-1979,2,2,0,0,0,0,0,0,0.000
2213,H Hiri (PNG),2016-2019,7,7,0,0,0,0,0,0,0.000
2214,VR Hogg (ZIM),1983-1983,2,2,0,0,0,0,0,0,0.000
2215,RG Holland (AUS),1985-1985,2,2,0,0,0,0,0,0,0.000
2216,DAW Hollis (BMUDA),2008-2008,1,1,0,0,0,0,0,0,0.000
2217,PA Horne (NZ),1987-1987,4,4,0,0,0,0,0,0,0.000
2218,Hussain Talat (PAK),2019-2019,1,1,0,0,0,0,0,0,0.000
2219,Ilyas Gull (HKG),2004-2004,2,2,0,0,0,0,0,0,0.000
2220,Intikhab Alam (PAK),1973-1976,4,4,0,0,0,0,0,0,0.000
2221,Iqbal Sikander (PAK),1992-1992,4,4,0,0,0,0,0,0,0.000
2222,Irfan Fazil (PAK),2000-2000,1,1,0,0,0,0,0,0,0.000
2223,Irfan Sajid (UAE),2014-2014,1,1,0,0,0,0,0,0,0.000
2224,Ishtiaq Muhammad (HKG),2016-2016,1,1,0,0,0,0,0,0,0.000
2225,W Jaffer (INDIA),2006-2006,2,2,0,0,0,0,0,0,0.000
2226,Jahangir Alam Talukdar (BDESH),1990-1990,2,2,0,0,0,0,0,0,0.000
2227,JA Jameson (ENG),1973-1975,3,3,0,0,0,0,0,0,0.000
2228,Jasdeep Singh (USA),2019-2019,4,4,0,0,0,0,0,0,0.000
2229,Jawahir Shah (EAf),1975-1975,3,3,0,0,0,0,0,0,0.000
2230,PS Jayaprakashdaran (SL),2005-2005,1,1,0,0,0,0,0,0,0.000
2231,RSA Jayasekera (SL),1982-1982,2,2,0,0,0,0,0,0,0.000
2232,NGRP Jayasuriya (SL),2018-2018,2,2,0,0,0,0,0,0,0.000
2233,TJ Jenner (AUS),1975-1975,1,1,0,0,0,0,0,0,0.000
2234,KCB Jeremy (WI),2000-2001,6,6,0,0,0,0,0,0,0.000
2235,K Jethi (CAN),2008-2008,3,3,0,0,0,0,0,0,0.000
2236,HR Johnson (USA),2004-2004,2,2,0,0,0,0,0,0,0.000
2237,RL Johnson (ENG),2003-2003,10,9,0,0,0,0,0,0,0.000
2238,RA Jones (NZ),2003-2003,5,5,0,0,0,0,0,0,0.000
2239,SP Jones (ENG),2004-2005,8,8,0,0,0,0,0,0,0.000
2240,C Jonker (SA),2018-2018,2,2,0,0,0,0,0,0,0.000
2241,S Jora (NEPAL),2019-2019,1,1,0,0,0,0,0,0,0.000
2242,D Joseph (CAN),2003-2003,4,4,0,0,0,0,0,0,0.000
2243,Junaid Zia (PAK),2003-2003,4,4,0,0,0,0,0,0,0.000
2244,R Kaia (ZIM),2015-2015,1,1,0,0,0,0,0,0,0.000
2245,AV Kale (INDIA),2003-2003,1,1,0,0,0,0,0,0,0.000
2246,LWS Kaluperuma (SL),1975-1982,4,4,0,0,0,0,0,0,0.000
2247,Kamran Hussain (PAK),2008-2008,2,2,0,0,0,0,0,0,0.000
2248,TS Kamunhukamwe (ZIM),2018-2019,3,3,0,0,0,0,0,0,0.000
2249,K Kamyuka (CAN),2013-2013,2,2,0,0,0,0,0,0,0.000
2250,AL Kandappah (CAN),2007-2007,2,2,0,0,0,0,0,0,0.000
2251,Karan KC (NEPAL),2018-2019,5,5,0,0,0,0,0,0,0.000
2252,Karim Janat (AFG),2017-2017,1,1,0,0,0,0,0,0,0.000
2253,Kashif Raza (PAK),2001-2001,1,1,0,0,0,0,0,0,0.000
2254,F Kasteni (ZIM),2007-2007,3,3,0,0,0,0,0,0,0.000
2255,E Katchay (CAN),2008-2009,5,5,0,0,0,0,0,0,0.000
2256,PHT Kaushal (SL),2015-2015,1,1,0,0,0,0,0,0,0.000
2257,RWT Key (ENG),2003-2004,5,5,0,0,0,0,0,0,0.000
2258,Khalid Khan (HKG),2004-2004,2,2,0,0,0,0,0,0,0.000
2259,Khaliq Dad (AFG),2009-2010,6,6,0,0,0,0,0,0,0.000
2260,GK Khoda (INDIA),1998-1998,2,2,0,0,0,0,0,0,0.000
2261,JP Kotze (NAM),2019-2019,5,5,0,0,0,0,0,0,0.000
2262,CK Kruger (HKG),2008-2008,2,2,0,0,0,0,0,0,0.000
2263,SC Kuggeleijn (NZ),2017-2017,2,2,0,0,0,0,0,0,0.000
2264,MKGCP Lakshitha (SL),2002-2003,7,7,0,0,0,0,0,0,0.000
2265,AV Lalcheta (OMAN),2019-2019,2,2,0,0,0,0,0,0,0.000
2266,SB Lama (HKG),2004-2004,1,1,0,0,0,0,0,0,0.000
2267,GA Lamb (ZIM),2010-2011,15,15,0,0,0,0,0,0,0.000
2268,CB Lambert (USA/WI),1990-2004,12,12,0,0,0,0,0,0,0.000
2269,TJ Laughlin (AUS),1978-1979,6,6,0,0,0,0,0,0,0.000
2270,DV Lawrence (ENG),1991-1991,1,1,0,0,0,0,0,0,0.000
2271,JJC Lawson (WI),2001-2005,13,12,0,0,0,0,0,0,0.000
2272,J Lewis (ENG),2005-2007,13,13,0,0,0,0,0,0,0.000
2273,Liaqat Ali (PAK),1977-1978,3,3,0,0,0,0,0,0,0.000
2274,GFJ Liebenberg (SA),1995-1998,4,4,0,0,0,0,0,0,0.000
2275,JB Little (IRE),2019-2019,4,4,0,0,0,0,0,0,0.000
2276,TA Lloyd (ENG),1984-1984,3,3,0,0,0,0,0,0,0.000
2277,CH Lonsdale (BMUDA),2007-2007,1,1,0,0,0,0,0,0,0.000
2278,AGR Loudon (ENG),2006-2006,1,1,0,0,0,0,0,0,0.000
2279,J Louw (SA),2008-2008,3,3,0,0,0,0,0,0,0.000
2280,MB Loye (ENG),2007-2007,7,7,0,0,0,0,0,0,0.000
2281,BW Luckhurst (ENG),1975-1975,3,3,0,0,0,0,0,0,0.000
2282,C McAuslan (HKG),2017-2017,2,2,0,0,0,0,0,0,0.000
2283,OC McCoy (WI),2018-2018,2,2,0,0,0,0,0,0,0.000
2284,JA Maclean (AUS),1979-1979,2,1,0,0,0,0,0,0,0.000
2285,H McLeod (EAf),1975-1975,2,2,0,0,0,0,0,0,0.000
2286,NJ MacRae (SCOT),2006-2006,2,2,0,0,0,0,0,0,0.000
2287,DSK Madushanka (SL),2018-2018,1,1,0,0,0,0,0,0,0.000
2288,LD Madushanka (SL),2017-2017,4,4,0,0,0,0,0,0,0.000
2289,KA Maharaj (SA),2017-2018,4,4,0,0,0,0,0,0,0.000
2290,Mahbubur Rahman (BDESH),1999-1999,1,1,0,0,0,0,0,0,0.000
2291,Mahmood Hamid (PAK),1995-1995,1,1,0,0,0,0,0,0,0.000
2292,DJ Malan (ENG),2019-2019,1,1,0,0,0,0,0,0,0.000
2293,AV Mankad (INDIA),1974-1974,1,1,0,0,0,0,0,0,0.000
2294,Mansoor Amjad (PAK),2008-2008,1,1,0,0,0,0,0,0,0.000
2295,Mansoor Rana (PAK),1990-1990,2,2,0,0,0,0,0,0,0.000
2296,Maqsood Rana (PAK),1990-1990,1,1,0,0,0,0,0,0,0.000
2297,CA Marshall (CAN),1979-1979,2,2,0,0,0,0,0,0,0.000
2298,JAH Marshall (NZ),2005-2008,10,10,0,0,0,0,0,0,0.000
2299,GC Martin (ZIM),1994-1995,5,5,0,0,0,0,0,0,0.000
2300,Masood Iqbal (PAK),1984-1984,1,1,0,0,0,0,0,0,0.000
2301,SJ Massiah (USA),2004-2004,2,2,0,0,0,0,0,0,0.000
2302,PS Masvaure (ZIM),2018-2018,2,2,0,0,0,0,0,0,0.000
2303,AW Mathieson (NZ),2015-2015,1,1,0,0,0,0,0,0,0.000
2304,BM Mauricette (CAN),1979-1979,3,3,0,0,0,0,0,0,0.000
2305,DES Maxwell (CAN),2006-2007,10,10,0,0,0,0,0,0,0.000
2306,Mazharul Haque (BDESH),2002-2002,1,1,0,0,0,0,0,0,0.000
2307,GJ McCarter (IRE),2014-2014,1,1,0,0,0,0,0,0,0.000
2308,SC Meaker (ENG),2011-2011,2,2,0,0,0,0,0,0,0.000
2309,Mehmood Quaraishy (EAf),1975-1975,3,3,0,0,0,0,0,0,0.000
2310,PS Mehta (EAf),1975-1975,1,1,0,0,0,0,0,0,0.000
2311,MA Meman (ZIM),1987-1987,1,1,0,0,0,0,0,0,0.000
2312,PHKD Mendis (SL),2019-2019,2,2,0,0,0,0,0,0,0.000
2313,JM Mennie (AUS),2016-2016,2,2,0,0,0,0,0,0,0.000
2314,PL Mhambrey (INDIA),1996-1998,3,3,0,0,0,0,0,0,0.000
2315,Mohammad Abbas (PAK),2019-2019,3,3,0,0,0,0,0,0,0.000
2316,Mohammad Aslam (UAE),1996-1996,4,4,0,0,0,0,0,0,0.000
2317,Mohammad Iqbal (CAN),2007-2008,5,5,0,0,0,0,0,0,0.000
2318,Mohammad Nazir (PAK),1980-1984,4,4,0,0,0,0,0,0,0.000
2319,Mohammad Talha (PAK),2014-2014,3,3,0,0,0,0,0,0,0.000
2320,Mohammed Siraj (INDIA),2019-2019,1,1,0,0,0,0,0,0,0.000
2321,Moin-ul-Atiq (PAK),1988-1989,5,5,0,0,0,0,0,0,0.000
2322,Moniruzzaman (BDESH),2003-2003,2,2,0,0,0,0,0,0,0.000
2323,DWO Morgan (BMUDA),2006-2006,2,2,0,0,0,0,0,0,0.000
2324,EA Moseley (WI),1990-1991,9,8,0,0,0,0,0,0,0.000
2325,PV Mpitsang (SA),1999-1999,2,2,0,0,0,0,0,0,0.000
2326,Mujahid Jamshed (PAK),1997-1997,4,4,0,0,0,0,0,0,0.000
2327,M Mulla (CAN),2007-2007,1,1,0,0,0,0,0,0,0.000
2328,AMN Munasinghe (SL),1994-1996,5,5,0,0,0,0,0,0,0.000
2329,Munir Dar (HKG),2008-2008,2,2,0,0,0,0,0,0,0.000
2330,GB Murgatroyd (NAM),2003-2003,6,6,0,0,0,0,0,0,0.000
2331,DJ Murray (NZ),1994-1994,1,1,0,0,0,0,0,0,0.000
2332,T Muzarabani (ZIM),2015-2016,8,8,0,0,0,0,0,0,0.000
2333,Nadeem Ghauri (PAK),1990-1990,6,6,0,0,0,0,0,0,0.000
2334,Nadeem Khan (PAK),1993-1995,2,2,0,0,0,0,0,0,0.000
2335,Naeem Ashraf (PAK),1995-1995,2,2,0,0,0,0,0,0,0.000
2336,J Nagenda (EAf),1975-1975,1,1,0,0,0,0,0,0,0.000
2337,SS Naik (INDIA),1974-1974,2,2,0,0,0,0,0,0,0.000
2338,KK Nair (INDIA),2016-2016,2,2,0,0,0,0,0,0,0.000
2339,Najaf Shah (PAK),2007-2007,1,1,0,0,0,0,0,0,0.000
2340,Najeeb Tarakai (AFG),2017-2017,1,1,0,0,0,0,0,0,0.000
2341,DP Nannes (AUS),2009-2009,1,1,0,0,0,0,0,0,0.000
2342,Naseer Malik (PAK),1975-1975,3,3,0,0,0,0,0,0,0.000
2343,Nasim-ul-Ghani (PAK),1973-1973,1,1,0,0,0,0,0,0,0.000
2344,Nasir Aziz (UAE),2014-2015,5,5,0,0,0,0,0,0,0.000
2345,Nasir Hameed (HKG),2004-2004,1,1,0,0,0,0,0,0,0.000
2346,Nasir Javed (USA),2004-2004,1,1,0,0,0,0,0,0,0.000
2347,Naumanullah (PAK),2008-2008,1,1,0,0,0,0,0,0,0.000
2348,Naved Anjum (PAK),1984-1992,13,13,0,0,0,0,0,0,0.000
2349,MN Nawaz (SL),1998-2002,3,3,0,0,0,0,0,0,0.000
2350,AM Nayar (INDIA),2009-2009,3,3,0,0,0,0,0,0,0.000
2351,N Ncube (ZIM),2011-2011,1,1,0,0,0,0,0,0,0.000
2352,A Ndlovu (ZIM),2019-2019,2,2,0,0,0,0,0,0,0.000
2353,MG Neser (AUS),2018-2018,2,2,0,0,0,0,0,0,0.000
2354,SO Ngoche (KENYA),2010-2014,14,14,0,0,0,0,0,0,0.000
2355,IA Nicolson (ZIM),2010-2010,2,2,0,0,0,0,0,0,0.000
2356,RG Nijman (NL),2009-2009,1,1,0,0,0,0,0,0,0.000
2357,AA Noffke (AUS),2008-2008,1,1,0,0,0,0,0,0,0.000
2358,Nurul Abedin (BDESH),1986-1990,4,4,0,0,0,0,0,0,0.000
2359,KJ O'Keeffe (AUS),1977-1977,2,2,0,0,0,0,0,0,0.000
2360,D Olivier (SA),2019-2019,2,2,0,0,0,0,0,0,0.000
2361,DR O'Sullivan (NZ),1974-1976,3,3,0,0,0,0,0,0,0.000
2362,MB Owens (NZ),1992-1992,1,1,0,0,0,0,0,0,0.000
2363,M Panchal (NL),2007-2007,1,1,0,0,0,0,0,0,0.000
2364,GK Pandey (INDIA),1999-1999,2,2,0,0,0,0,0,0,0.000
2365,BA Parchment (WI),2007-2008,7,7,0,0,0,0,0,0,0.000
2366,SD Parry (ENG),2014-2014,2,2,0,0,0,0,0,0,0.000
2367,Parvez Rasool (INDIA),2014-2014,1,1,0,0,0,0,0,0,0.000
2368,NT Pascal (WI),2009-2009,1,1,0,0,0,0,0,0,0.000
2369,SP Pasqual (SL),1979-1979,2,2,0,0,0,0,0,0,0.000
2370,A Patel (CAN),2003-2003,2,2,0,0,0,0,0,0,0.000
2371,JM Patel (CAN),1979-1979,3,3,0,0,0,0,0,0,0.000
2372,KA Patel (KENYA),2006-2006,2,2,0,0,0,0,0,0,0.000
2373,ML Patel (KENYA),2004-2006,3,3,0,0,0,0,0,0,0.000
2374,RGM Patel (INDIA),1988-1988,1,1,0,0,0,0,0,0,0.000
2375,R Pathan (CAN),2013-2013,1,1,0,0,0,0,0,0,0.000
2376,BMW Patterson (SCOT),1999-1999,3,3,0,0,0,0,0,0,0.000
2377,GE Peckover (ZIM),1983-1983,3,3,0,0,0,0,0,0,0.000
2378,KG Perera (SL),1986-1986,1,1,0,0,0,0,0,0,0.000
2379,N Phillip (WI),1978-1978,1,1,0,0,0,0,0,0,0.000
2380,HSM Pieris (SL),1975-1975,3,3,0,0,0,0,0,0,0.000
2381,ADJ Pitcher (BMUDA),2007-2007,3,3,0,0,0,0,0,0,0.000
2382,PI Pocock (ENG),1985-1985,1,1,0,0,0,0,0,0,0.000
2383,DJ Pringle (EAf),1975-1975,2,2,0,0,0,0,0,0,0.000
2384,CA Pujara (INDIA),2013-2014,5,4,0,0,0,0,0,0,0.000
2385,Y Punja (UAE),2015-2015,1,1,0,0,0,0,0,0,0.000
2386,M Pushpakumara (SL),2009-2010,3,2,0,0,0,0,0,0,0.000
2387,CT Radley (ENG),1978-1978,4,4,0,0,0,0,0,0,0.000
2388,Rafiqul Alam (BDESH),1986-1986,2,2,0,0,0,0,0,0,0.000
2389,Rafiqul Islam (BDESH),2002-2002,1,1,0,0,0,0,0,0,0.000
2390,RR Ramdass (WI),2005-2005,1,1,0,0,0,0,0,0,0.000
2391,D Ramnarine (WI),1997-2001,4,4,0,0,0,0,0,0,0.000
2392,DR Ramsammy (CAN),2012-2012,1,1,0,0,0,0,0,0,0.000
2393,Ramveer Rai (UAE),2004-2004,1,1,0,0,0,0,0,0,0.000
2394,AN Ranasinghe (SL),1975-1982,9,9,0,0,0,0,0,0,0.000
2395,N Ranatunga (SL),1993-1993,2,2,0,0,0,0,0,0,0.000
2396,Randhir Singh (INDIA),1981-1983,2,2,0,0,0,0,0,0,0.000
2397,Rashid Zia (USA),2004-2004,2,2,0,0,0,0,0,0,0.000
2398,NLK Ratnayake (SL),1989-1990,2,2,0,0,0,0,0,0,0.000
2399,SS Raul (INDIA),1998-1998,2,2,0,0,0,0,0,0,0.000
2400,Raza Hasan (PAK),2014-2014,1,1,0,0,0,0,0,0,0.000
2401,RE Redmond (NZ),1973-1973,2,2,0,0,0,0,0,0,0.000
2402,B Regmi (NEPAL),2018-2019,4,4,0,0,0,0,0,0,0.000
2403,CA Reid (USA),2004-2004,2,2,0,0,0,0,0,0,0.000
2404,RA Reifer (WI),2019-2019,2,2,0,0,0,0,0,0,0.000
2405,CEB Rice (SA),1991-1991,3,3,0,0,0,0,0,0,0.000
2406,EJ Richardson (IRE),2013-2013,2,2,0,0,0,0,0,0,0.000
2407,EB Ringera (KENYA),2011-2011,1,1,0,0,0,0,0,0,0.000
2408,HP Rinke (ZIM),2006-2006,18,18,0,0,0,0,0,0,0.000
2409,Rizwan Latif (UAE),2004-2004,1,1,0,0,0,0,0,0,0.000
2410,SJ Roberts (NZ),1990-1990,2,2,0,0,0,0,0,0,0.000
2411,Robiul Islam (BDESH),2013-2013,3,3,0,0,0,0,0,0,0.000
2412,TS Roland-Jones (ENG),2017-2017,1,1,0,0,0,0,0,0,0.000
2413,Saad Ali (PAK),2019-2019,2,2,0,0,0,0,0,0,0.000
2414,Saad Nasim (PAK),2015-2015,3,3,0,0,0,0,0,0,0.000
2415,Sagar Pun (NEPAL),2018-2018,1,1,0,0,0,0,0,0,0.000
2416,Saiful Islam (BDESH),1990-1997,7,7,0,0,0,0,0,0,0.000
2417,Sajjad Ahmed (BDESH),1995-1995,2,2,0,0,0,0,0,0,0.000
2418,Sajjad Akbar (PAK),1990-1990,2,2,0,0,0,0,0,0,0.000
2419,Saleem Pervez (PAK),1980-1980,1,1,0,0,0,0,0,0,0.000
2420,Saleem Raza (UAE),1994-1996,6,6,0,0,0,0,0,0,0.000
2421,Salman Faris (UAE),2014-2014,3,3,0,0,0,0,0,0,0.000
2422,Salman Farooq (UAE),2014-2014,1,1,0,0,0,0,0,0,0.000
2423,Samiullah Khan (PAK),2008-2008,2,2,0,0,0,0,0,0,0.000
2424,Sami Aslam (PAK),2015-2016,4,4,0,0,0,0,0,0,0.000
2425,Sami Faridi (CAN),2008-2008,3,3,0,0,0,0,0,0,0.000
2426,GS Sandhu (AUS),2015-2015,2,2,0,0,0,0,0,0,0.000
2427,Saqib Zulfiqar (NL),2019-2019,1,1,0,0,0,0,0,0,0.000
2428,P Sarraf (NEPAL),2019-2019,2,2,0,0,0,0,0,0,0.000
2429,Sayed Shirzad (AFG),2019-2019,2,1,0,0,0,0,0,0,0.000
2430,RH Scholte (NL),2002-2003,5,5,0,0,0,0,0,0,0.000
2431,BM Scholtz (NAM),2019-2019,5,5,0,0,0,0,0,0,0.000
2432,BN Schultz (SA),1992-1992,1,1,0,0,0,0,0,0,0.000
2433,GR Sealy (CAN),1979-1979,3,3,0,0,0,0,0,0,0.000
2434,TAP Sekhar (INDIA),1983-1985,4,4,0,0,0,0,0,0,0.000
2435,Shafiuddin Ahmed (BDESH),1997-2000,11,11,0,0,0,0,0,0,0.000
2436,Shaheedur Rahman (BDESH),1986-1986,2,2,0,0,0,0,0,0,0.000
2437,Shahid Anwar (PAK),1996-1996,1,1,0,0,0,0,0,0,0.000
2438,Shehzad Altaf (UAE),1996-1996,2,2,0,0,0,0,0,0,0.000
2439,Shahzad Khan (CAN),2007-2007,1,1,0,0,0,0,0,0,0.000
2440,Shahzaib Hasan (PAK),2010-2010,3,3,0,0,0,0,0,0,0.000
2441,Shakeel Ahmed jnr (PAK),1995-1995,2,2,0,0,0,0,0,0,0.000
2442,Shakeel Khan (PAK),1987-1987,1,1,0,0,0,0,0,0,0.000
2443,A Shamshudeen (CAN),2007-2007,1,1,0,0,0,0,0,0,0.000
2444,JNK Shannon (IRE),2013-2013,1,1,0,0,0,0,0,0,0.000
2445,Shariful Haque (BDESH),1998-1998,1,1,0,0,0,0,0,0,0.000
2446,PH Sharma (INDIA),1976-1976,2,2,0,0,0,0,0,0,0.000
2447,AP Sheahan (AUS),1972-1972,3,3,0,0,0,0,0,0,0.000
2448,Sheikh Salahuddin (BDESH),1997-1997,6,6,0,0,0,0,0,0,0.000
2449,V Shetty (UAE),2008-2014,2,2,0,0,0,0,0,0,0.000
2450,M Shezi (SA),2014-2014,1,1,0,0,0,0,0,0,0.000
2451,S Shivnarine (WI),1978-1978,1,1,0,0,0,0,0,0,0.000
2452,Shubman Gill (INDIA),2019-2019,2,2,0,0,0,0,0,0,0.000
2453,Shuvagata Hom (BDESH),2011-2011,4,4,0,0,0,0,0,0,0.000
2454,JD Siddons (AUS),1988-1988,1,1,0,0,0,0,0,0,0.000
2455,EHSN Silva (UAE),2008-2008,1,1,0,0,0,0,0,0,0.000
2456,KJ Silva (SL),1995-1995,1,1,0,0,0,0,0,0,0.000
2457,CEW Silverwood (ENG),1996-2001,7,7,0,0,0,0,0,0,0.000
2458,Simandeep Singh (HKG),2018-2018,1,1,0,0,0,0,0,0,0.000
2459,RP Singh (INDIA),1986-1986,2,2,0,0,0,0,0,0,0.000
2460,Skhawat Ali (HKG),2008-2014,4,4,0,0,0,0,0,0,0.000
2461,WN Slack (ENG),1986-1986,2,2,0,0,0,0,0,0,0.000
2462,CL Smith (ENG),1984-1984,4,4,0,0,0,0,0,0,0.000
2463,DM Smith (ENG),1986-1990,2,2,0,0,0,0,0,0,0.000
2464,M Smith (BMUDA),2008-2008,1,1,0,0,0,0,0,0,0.000
2465,MJ Smith (SCOT),1999-1999,5,5,0,0,0,0,0,0,0.000
2466,RAJ Smith (SCOT),2016-2016,2,2,0,0,0,0,0,0,0.000
2467,G Snyman (NAM),2003-2003,5,5,0,0,0,0,0,0,0.000
2468,Sohail Butt (UAE),1994-1994,2,2,0,0,0,0,0,0,0.000
2469,S Somasunder (INDIA),1996-1996,2,2,0,0,0,0,0,0,0.000
2470,TE Srinivasan (INDIA),1980-1981,2,2,0,0,0,0,0,0,0.000
2471,RW Staple (USA),2004-2004,2,2,0,0,0,0,0,0,0.000
2472,NA Statham (NL),2003-2009,3,3,0,0,0,0,0,0,0.000
2473,MP Stead (CAN),1979-1979,2,2,0,0,0,0,0,0,0.000
2474,RD Steede (BMUDA),2006-2008,8,8,0,0,0,0,0,0,0.000
2475,DS Steele (ENG),1976-1976,1,1,0,0,0,0,0,0,0.000
2476,SL Stewart (NZ),2010-2010,4,4,0,0,0,0,0,0,0.000
2477,PJR Steyn (SA),1995-1995,1,1,0,0,0,0,0,0,0.000
2478,OP Stone (ENG),2018-2018,4,3,0,0,0,0,0,0,0.000
2479,Subashis Roy (BDESH),2016-2016,1,1,0,0,0,0,0,0,0.000
2480,Sultan Ahmed (UAE),2019-2019,2,2,0,0,0,0,0,0,0.000
2481,GP Sulzberger (NZ),2000-2000,3,3,0,0,0,0,0,0,0.000
2482,S Sumar (EAf),1975-1975,1,1,0,0,0,0,0,0,0.000
2483,Sunzamul Islam (BDESH),2017-2018,3,3,0,0,0,0,0,0,0.000
2484,SJ Swanepoel (NAM),2003-2003,5,5,0,0,0,0,0,0,0.000
2485,Tabarak Dar (HKG),2004-2008,4,4,0,0,0,0,0,0,0.000
2486,AR Tait (NZ),1998-1999,5,5,0,0,0,0,0,0,0.000
2487,Tanvir Mehdi (PAK),1992-1992,1,1,0,0,0,0,0,0,0.000
2488,Tariq Javed (CAN),1979-1979,3,3,0,0,0,0,0,0,0.000
2489,JP Taylor (ENG),1993-1993,1,1,0,0,0,0,0,0,0.000
2490,LB Taylor (ENG),1986-1986,2,2,0,0,0,0,0,0,0.000
2491,DJ Terbrugge (SA),2000-2000,4,4,0,0,0,0,0,0,0.000
2492,DJ ter Braak (NL),2018-2018,2,2,0,0,0,0,0,0,0.000
2493,VAB Tewarie (NL),2011-2011,1,1,0,0,0,0,0,0,0.000
2494,JG Thomas (ENG),1986-1987,3,3,0,0,0,0,0,0,0.000
2495,O Thomas (WI),2018-2019,19,18,0,0,0,0,0,0,0.000
2496,EP Thompson (NZ),2009-2009,1,1,0,0,0,0,0,0,0.000
2497,PIC Thompson (WI),1997-1997,2,2,0,0,0,0,0,0,0.000
2498,AL Thomson (AUS),1971-1971,1,1,0,0,0,0,0,0,0.000
2499,MH Tissera (SL),1975-1975,3,3,0,0,0,0,0,0,0.000
2500,GC Tonge (WI),2009-2009,5,5,0,0,0,0,0,0,0.000
2501,PM Toohey (AUS),1978-1979,5,4,0,0,0,0,0,0,0.000
2502,GS Trimble (AUS),1986-1986,2,2,0,0,0,0,0,0,0.000
2503,MS Tshabalala (SA),2007-2007,4,4,0,0,0,0,0,0,0.000
2504,CM Tuckett (WI),1998-1998,1,1,0,0,0,0,0,0,0.000
2505,ML Udawatte (SL),2008-2008,9,9,0,0,0,0,0,0,0.000
2506,JD Unadkat (INDIA),2013-2013,7,7,0,0,0,0,0,0,0.000
2507,Usman Mushtaq (UAE),2015-2015,1,1,0,0,0,0,0,0,0.000
2508,T van der Gugten (NL),2012-2013,4,4,0,0,0,0,0,0,0.000
2509,MG Vandort (SL),2006-2006,1,1,0,0,0,0,0,0,0.000
2510,PA van Meekeren (NL),2013-2019,5,5,0,0,0,0,0,0,0.000
2511,MWA van Nierop (NL),2006-2006,2,2,0,0,0,0,0,0,0.000
2512,KJJ van Noortwijk (NL),1996-2003,9,9,0,0,0,0,0,0,0.000
2513,BO van Rooi (NAM),2003-2003,3,3,0,0,0,0,0,0,0.000
2514,RJ van Vuuren (NAM),2003-2003,5,5,0,0,0,0,0,0,0.000
2515,CJPG van Zyl (SA),1992-1992,2,2,0,0,0,0,0,0,0.000
2516,JCB Vaughan (CAN),1979-1979,3,3,0,0,0,0,0,0,0.000
2517,M Venkataramana (INDIA),1988-1988,1,1,0,0,0,0,0,0,0.000
2518,S Vesawkar (NEPAL),2018-2018,1,1,0,0,0,0,0,0,0.000
2519,GE Vivian (NZ),1973-1973,1,1,0,0,0,0,0,0,0.000
2520,DM Vonhagt (SL),1985-1985,1,1,0,0,0,0,0,0,0.000
2521,Wahidul Gani (BDESH),1988-1988,1,1,0,0,0,0,0,0,0.000
2522,KP Walmsley (NZ),2003-2003,2,2,0,0,0,0,0,0,0.000
2523,HR Walsh (USA),2019-2019,1,1,0,0,0,0,0,0,0.000
2524,R Walters (NAM),2003-2003,2,2,0,0,0,0,0,0,0.000
2525,S Walusimbi (EAf),1975-1975,3,3,0,0,0,0,0,0,0.000
2526,Waqas Khan (HKG),2015-2017,8,8,0,0,0,0,0,0,0.000
2527,Wasim Haider (PAK),1992-1992,3,3,0,0,0,0,0,0,0.000
2528,SL Watkin (ENG),1994-1994,4,4,0,0,0,0,0,0,0.000
2529,M Watkinson (ENG),1996-1996,1,1,0,0,0,0,0,0,0.000
2530,GD Watson (AUS),1972-1972,2,2,0,0,0,0,0,0,0.000
2531,RJ Webb (NZ),1983-1983,3,3,0,0,0,0,0,0,0.000
2532,AP Weerakkody (SL),1994-1994,1,1,0,0,0,0,0,0,0.000
2533,S Weerakoon (SL),2012-2012,2,2,0,0,0,0,0,0,0.000
2534,AP Wells (ENG),1995-1995,1,1,0,0,0,0,0,0,0.000
2535,CM Wells (ENG),1985-1985,2,2,0,0,0,0,0,0,0.000
2536,MD Wettimuny (SL),1983-1983,1,1,0,0,0,0,0,0,0.000
2537,SRD Wettimuny (SL),1975-1979,3,3,0,0,0,0,0,0,0.000
2538,K Whatham (CAN),2011-2011,1,1,0,0,0,0,0,0,0.000
2539,DF Whatmore (AUS),1980-1980,1,1,0,0,0,0,0,0,0.000
2540,RK Whelan (IRE),2007-2007,2,2,0,0,0,0,0,0,0.000
2541,RPAH Wickramaratne (SL),1993-1993,3,3,0,0,0,0,0,0,0.000
2542,D Wiese (SA),2015-2016,6,6,0,0,0,0,0,0,0.000
2543,KOK Williams (WI),2017-2018,8,8,0,0,0,0,0,0,0.000
2544,JG Williamson (SCOT),1999-1999,2,2,0,0,0,0,0,0,0.000
2545,CM Willoughby (SA),2000-2003,3,3,0,0,0,0,0,0,0.000
2546,AJ Woodcock (AUS),1974-1974,1,1,0,0,0,0,0,0,0.000
2547,LJ Woodcock (NZ),2011-2011,4,4,0,0,0,0,0,0,0.000
2548,HN Ya France (NAM),2019-2019,4,4,0,0,0,0,0,0,0.000
2549,T Yohannan (INDIA),2002-2002,3,3,0,0,0,0,0,0,0.000
2550,Yunus Badat (EAf),1975-1975,2,2,0,0,0,0,0,0,0.000
2551,Zafar Gohar (PAK),2015-2015,1,1,0,0,0,0,0,0,0.000
2552,Zaheer Maqsood (UAE),2015-2015,2,2,0,0,0,0,0,0,0.000
2553,Zahid Ahmed (PAK),1987-1987,2,2,0,0,0,0,0,0,0.000
2554,Zahid Razzak (BDESH),1988-1990,3,3,0,0,0,0,0,0,0.000
2555,Zahid Shah (UAE),2008-2008,2,2,0,0,0,0,0,0,0.000
2556,MZ Zahir (CAN),2009-2009,1,1,0,0,0,0,0,0,0.000
2557,Zahir Khan (AFG),2019-2019,1,1,0,0,0,0,0,0,0.000
2558,Zain Abbas (HKG),2008-2008,1,1,0,0,0,0,0,0,0.000
2559,Zakir Hasan (BDESH),1997-1997,1,1,0,0,0,0,0,0,0.000
2560,Zakir Hossain (BDESH),1998-1998,1,1,0,0,0,0,0,0,0.000
2561,Zakir Khan (PAK),1984-1990,17,16,0,0,0,0,0,0,0.000
2562,Zakiullah Zaki (AFG),2012-2012,1,1,0,0,0,0,0,0,0.000
2563,Zeeshan Siddiqi (CAN),2012-2014,2,2,0,0,0,0,0,0,0.000
2564,Zulfiqar Babar (PAK),2014-2015,5,5,0,0,0,0,0,0,0.000
